1;1.0;1220;1.0;0;0;1220;6;325000.0
3;2.0;1640;1.0;0;0;1640;7;375000.0
5;2.25;2510;1.0;0;0;2510;9;900000.0
4;2.5;2660;1.0;0;780;1880;8;513000.0
3;2.0;1470;1.0;0;0;1470;6;344950.0
4;2.0;2450;2.0;0;250;2200;8;969000.0
4;2.5;2440;2.0;0;0;2440;8;680000.0
4;2.25;2670;1.0;0;1060;1610;8;437850.0
2;1.0;1010;1.0;0;0;1010;6;450000.0
3;2.5;1690;2.0;0;0;1690;7;270000.0
3;1.0;1070;1.0;0;120;950;7;500000.0
3;2.75;1540;1.0;0;330;1210;7;503000.0
2;1.0;1140;1.0;0;0;1140;7;549000.0
3;1.5;1820;1.0;0;0;1820;7;875000.0
3;2.5;2760;2.0;0;0;2760;10;834538.0
6;3.5;2410;2.0;0;190;2220;9;767500.0
2;1.5;1430;3.0;0;0;1430;7;297000.0
2;1.0;1040;1.0;0;0;1040;6;160000.0
6;4.25;5860;2.0;0;1710;4150;10;1750000.0
3;2.0;1780;1.0;0;0;1780;7;280000.0
4;2.5;2500;1.0;0;0;2500;10;806000.0
4;2.0;3090;1.0;0;0;3090;7;870000.0
3;2.5;2370;2.0;0;0;2370;8;404000.0
2;1.5;1200;2.0;0;200;1000;8;455000.0
3;2.5;2240;2.0;0;0;2240;8;1080000.0
4;2.0;2260;1.0;0;0;2260;9;685000.0
6;4.5;2810;1.0;0;800;2010;8;290000.0
3;1.75;1460;2.0;1;340;1120;8;629000.0
4;3.5;2980;2.0;0;0;2980;9;1339000.0
4;2.25;1660;1.0;0;0;1660;8;610000.0
5;1.5;1550;1.0;0;0;1550;7;510000.0
4;2.5;3118;2.0;0;0;3118;9;541800.0
2;2.0;2360;1.5;0;0;2360;9;1087500.0
3;2.5;2920;3.0;0;0;2920;10;868500.0
3;1.75;1330;1.0;0;0;1330;7;475000.0
3;1.5;2710;1.5;0;540;2170;7;442500.0
5;1.75;2000;1.0;0;1000;1000;7;620000.0
4;2.25;1870;2.0;0;0;1870;7;313999.0
3;2.5;1940;2.0;0;0;1940;8;324000.0
2;1.5;2730;1.0;0;1160;1570;8;460000.0
4;1.75;1870;1.0;0;800;1070;7;285000.0
3;1.0;860;1.5;0;0;860;7;397000.0
2;1.0;2180;1.0;0;1090;1090;7;490000.0
3;2.5;1650;2.0;0;0;1650;8;472500.0
3;1.0;920;1.0;0;0;920;6;179000.0
4;1.0;2080;1.0;0;1040;1040;7;480000.0
3;2.0;2140;1.0;0;660;1480;8;346150.0
3;2.25;2220;2.0;0;0;2220;8;470000.0
2;1.75;1460;1.0;0;500;960;7;390500.0
3;1.75;1780;1.0;0;500;1280;7;342000.0
2;2.0;1680;2.0;0;0;1680;7;210000.0
4;3.0;2940;2.0;0;720;2220;9;870000.0
4;3.25;4280;2.0;0;0;4280;11;1928000.0
3;1.0;1320;1.0;0;0;1320;7;159000.0
4;3.5;3200;1.0;0;500;2700;8;935100.0
4;2.5;1800;2.0;0;0;1800;7;285000.0
4;2.25;1840;1.0;0;450;1390;7;442500.0
3;2.5;1782;3.0;0;0;1782;7;326000.0
3;1.75;1800;1.0;0;410;1390;8;493500.0
3;1.0;1480;1.0;0;0;1480;7;479000.0
4;2.5;2580;2.0;0;0;2580;8;354000.0
3;2.5;1610;2.0;0;0;1610;7;245000.0
5;3.25;4410;2.0;0;2080;2330;9;600000.0
2;2.0;1540;2.0;0;0;1540;7;475000.0
4;2.0;2030;2.0;0;0;2030;7;275000.0
2;1.75;860;1.0;0;0;860;7;442000.0
4;2.5;2420;2.0;0;0;2420;8;298000.0
4;2.5;2260;1.0;0;490;1770;8;865000.0
3;2.75;2250;2.5;0;420;1830;9;765000.0
3;1.0;1900;1.5;0;0;1900;5;239950.0
5;1.75;2220;1.5;0;800;1420;7;607500.0
2;1.5;1190;2.0;0;0;1190;8;555000.0
3;3.0;2410;2.0;0;0;2410;7;537000.0
2;1.5;2060;1.5;0;0;2060;7;213500.0
5;2.5;2510;1.0;0;1250;1260;7;510000.0
4;4.0;4920;2.0;0;640;4280;10;1408760.0
2;1.75;1460;1.0;0;610;850;7;540000.0
4;2.25;2200;2.0;0;0;2200;8;512500.0
3;2.25;1540;1.0;0;770;770;7;312000.0
4;2.5;2070;2.0;0;0;2070;7;320000.0
4;2.5;3320;2.0;0;0;3320;10;805000.0
3;1.0;960;1.0;0;0;960;7;405000.0
1;1.0;960;1.0;0;0;960;5;420850.0
3;3.25;1220;2.0;0;290;930;8;526000.0
4;2.5;2500;2.0;0;0;2500;7;475000.0
2;1.0;1250;1.0;0;0;1250;7;511000.0
2;2.25;2160;3.0;0;0;2160;8;798750.0
2;1.0;1050;1.0;0;170;880;7;650000.0
3;2.5;2740;2.0;0;0;2740;9;363000.0
3;1.75;1810;1.0;0;0;1810;7;443000.0
4;1.0;1440;1.5;0;0;1440;7;395000.0
2;1.0;910;1.0;0;0;910;5;533050.0
3;2.5;1560;2.0;0;0;1560;7;295000.0
3;2.25;1450;2.0;0;270;1180;8;465000.0
4;2.5;3060;1.0;0;1360;1700;8;475000.0
4;2.5;2130;2.0;0;0;2130;9;620000.0
2;1.75;2070;1.0;0;810;1260;7;577000.0
3;2.5;1780;3.0;0;0;1780;8;365000.0
3;1.0;800;1.5;0;0;800;6;465000.0
3;1.0;1460;1.5;0;0;1460;7;405000.0
2;1.75;2060;1.0;0;1030;1030;7;485000.0
3;2.0;1690;1.0;0;750;940;7;356200.0
3;1.5;1270;3.0;0;0;1270;8;415000.0
4;3.5;3760;2.0;0;810;2950;9;740000.0
4;2.25;2590;2.0;0;0;2590;8;673000.0
4;3.5;3510;2.0;0;760;2750;8;540000.0
3;2.75;3080;2.0;0;0;3080;9;585000.0
5;2.75;1800;1.5;0;400;1400;7;533000.0
2;2.0;1320;1.5;0;0;1320;6;404500.0
3;2.75;2720;3.0;0;0;2720;8;455000.0
3;1.0;1300;1.0;0;380;920;7;325000.0
3;2.5;2050;1.0;0;450;1600;9;760000.0
2;1.0;730;1.0;0;0;730;7;378500.0
4;2.5;2440;2.0;0;0;2440;8;745641.0
3;3.0;2110;1.0;0;1000;1110;7;565000.0
3;2.25;1740;1.0;0;350;1390;7;289950.0
3;2.25;1820;2.0;0;0;1820;8;489950.0
4;1.75;2080;1.0;0;750;1330;8;300000.0
4;3.25;4360;2.0;0;960;3400;11;1258000.0
2;1.0;900;1.0;0;0;900;7;553000.0
3;2.5;1710;2.0;0;0;1710;7;415000.0
2;1.75;1570;3.0;0;0;1570;9;695000.0
3;1.5;2400;1.0;0;1200;1200;7;338000.0
5;2.75;3520;2.0;0;0;3520;10;1099880.0
4;2.25;2140;1.0;0;670;1470;7;465000.0
2;1.0;900;1.0;0;0;900;6;329950.0
3;2.5;1710;2.0;0;570;1140;8;579000.0
3;2.5;1700;2.0;0;0;1700;8;349950.0
2;2.25;1290;3.0;0;0;1290;8;500000.0
3;1.75;1300;1.0;0;0;1300;7;224500.0
3;2.25;2840;2.0;0;0;2840;9;490000.0
3;2.5;1600;1.0;0;660;940;7;439500.0
3;2.0;1700;1.0;0;0;1700;7;429000.0
5;3.25;3730;1.0;0;0;3730;10;2535000.0
4;3.25;4250;2.0;0;1230;3020;12;1615000.0
3;1.75;3150;1.0;0;780;2370;8;450000.0
3;2.75;2030;1.0;0;630;1400;8;643000.0
2;1.0;1370;1.0;0;0;1370;7;296000.0
4;2.75;3030;2.0;0;0;3030;8;608250.0
4;2.25;2420;2.0;0;0;2420;8;975000.0
4;1.0;1680;1.5;0;0;1680;6;366350.0
4;3.5;3560;2.0;0;1000;2560;10;1395000.0
5;2.0;1700;1.0;0;700;1000;7;337500.0
5;2.5;2340;1.0;0;670;1670;8;235500.0
4;3.5;3040;2.0;0;620;2420;9;684000.0
3;2.5;1400;1.0;0;280;1120;7;267500.0
5;3.5;2450;2.0;0;0;2450;9;559950.0
3;1.0;1140;1.0;0;0;1140;7;379000.0
3;2.0;1580;1.0;0;790;790;7;489950.0
4;1.0;1330;1.0;0;0;1330;6;1050000.0
5;2.5;2210;1.0;0;780;1430;9;648000.0
3;1.5;1210;1.0;0;0;1210;6;132825.0
3;1.0;1380;1.0;0;440;940;7;230000.0
3;2.5;2370;2.0;0;0;2370;8;685000.0
2;1.0;1130;1.0;0;0;1130;7;216000.0
3;2.5;1530;2.0;0;0;1530;7;379000.0
4;1.5;1810;1.0;0;600;1210;8;495000.0
3;2.5;1890;2.0;0;0;1890;7;265000.0
2;2.5;1270;3.0;0;0;1270;7;348000.0
4;2.75;2530;1.0;0;1250;1280;8;354950.0
4;2.75;2610;3.0;0;700;1910;8;650000.0
4;2.5;4040;2.0;0;0;4040;10;765000.0
5;3.0;3480;2.0;0;0;3480;8;590000.0
4;2.75;2110;2.0;0;0;2110;8;325000.0
3;2.5;2200;2.0;0;0;2200;8;302495.0
3;2.75;3910;1.0;0;1940;1970;9;1475000.0
3;2.5;1990;2.0;0;0;1990;8;544900.0
4;2.5;2800;2.0;0;0;2800;8;350000.0
2;1.5;1160;2.0;0;0;1160;7;289000.0
1;0.75;760;1.0;1;0;760;5;369900.0
3;1.0;1020;1.0;0;140;880;6;385000.0
3;1.5;1650;1.0;0;520;1130;8;390000.0
3;1.0;1000;1.0;0;0;1000;7;249000.0
5;2.5;3100;2.5;0;0;3100;9;1600000.0
5;1.5;1690;1.5;0;0;1690;7;285900.0
3;2.0;3040;1.0;0;1520;1520;8;500000.0
2;1.0;700;1.0;0;0;700;6;399000.0
4;2.75;5470;2.0;1;1740;3730;11;1612500.0
3;2.5;1852;2.0;0;0;1852;7;298000.0
5;2.5;2732;1.0;0;862;1870;8;480000.0
3;1.0;1400;1.5;0;0;1400;5;343000.0
4;1.75;1760;1.0;0;880;880;7;620047.0
3;2.5;1630;2.0;0;0;1630;8;360400.0
5;2.5;2990;2.0;0;0;2990;8;357000.0
4;3.5;4680;2.0;0;1640;3040;10;1350000.0
3;2.5;2185;2.0;0;0;2185;9;374000.0
5;1.75;1930;1.0;0;0;1930;8;218000.0
3;1.0;1630;1.0;0;0;1630;7;415000.0
4;2.0;1760;1.5;0;0;1760;7;720000.0
4;2.75;2510;1.0;0;880;1630;8;664000.0
5;3.5;5230;2.0;0;780;4450;11;1987500.0
4;2.5;2280;2.0;0;0;2280;7;305000.0
3;2.5;2380;2.0;0;0;2380;9;650000.0
3;1.75;1430;1.0;0;0;1430;7;424000.0
4;2.5;2400;2.0;0;0;2400;8;299000.0
3;2.5;2577;2.0;0;0;2577;8;495000.0
4;2.5;2480;1.0;0;660;1820;9;1013050.0
6;2.25;2550;2.0;0;0;2550;7;1020000.0
3;2.0;2160;1.5;0;0;2160;8;355000.0
4;2.5;3460;2.0;0;0;3460;10;746500.0
2;1.75;1520;1.0;0;680;840;7;470000.0
5;2.75;2710;2.0;0;0;2710;8;430760.0
1;1.0;710;1.0;0;100;610;6;390000.0
3;1.0;1120;1.0;0;0;1120;7;343000.0
3;1.5;1270;1.0;0;120;1150;7;260000.0
4;1.75;1850;2.0;0;0;1850;8;763000.0
3;3.25;3800;2.0;0;0;3800;9;630000.0
3;2.25;1650;2.0;0;0;1650;7;370000.0
2;2.5;1090;2.0;0;0;1090;7;310000.0
4;1.5;2040;1.0;0;1020;1020;7;510000.0
3;1.75;2430;1.5;0;600;1830;7;780000.0
4;1.75;1730;1.0;0;0;1730;8;515000.0
3;1.0;1390;1.0;0;0;1390;7;199000.0
3;2.75;1840;2.0;0;140;1700;10;599000.0
4;2.75;2430;1.0;0;0;2430;7;465425.0
6;2.5;2890;1.0;0;1260;1630;8;502000.0
3;2.5;1680;2.0;0;0;1680;7;394000.0
3;1.75;1350;1.0;0;0;1350;7;385000.0
3;2.25;2010;2.0;0;0;2010;8;530000.0
4;2.25;2590;2.0;0;0;2590;8;550000.0
4;2.5;3330;2.0;0;0;3330;9;760000.0
3;2.0;3250;2.0;0;0;3250;8;562000.0
3;2.5;1880;1.0;0;630;1250;8;355000.0
5;2.0;2450;1.0;0;1210;1240;7;550000.0
3;2.5;2050;3.0;0;0;2050;7;427000.0
3;1.75;1650;1.0;0;0;1650;7;267500.0
5;1.5;2420;1.0;0;920;1500;8;332000.0
5;2.25;2230;1.0;0;910;1320;8;482000.0
3;2.5;1650;2.0;0;0;1650;8;485000.0
3;1.5;1680;1.0;0;0;1680;8;356000.0
4;2.5;1690;1.0;0;610;1080;7;238000.0
3;1.5;1250;1.0;0;0;1250;6;350000.0
4;2.25;1910;1.0;0;610;1300;8;650000.0
4;2.5;1740;2.0;0;0;1740;7;302000.0
2;1.0;860;1.0;0;0;860;7;370000.0
2;1.75;590;1.0;0;0;590;5;156000.0
3;2.25;2530;2.0;0;0;2530;8;380000.0
3;2.25;2570;2.0;0;400;2170;7;538000.0
3;2.5;2300;2.0;0;0;2300;9;683000.0
3;2.75;2310;2.0;0;290;2020;10;713000.0
5;2.0;2610;1.0;0;900;1710;7;439000.0
3;2.5;1480;2.0;0;0;1480;7;516500.0
4;2.25;1900;1.0;0;0;1900;8;270000.0
4;2.75;3280;2.0;0;0;3280;10;734500.0
2;1.0;1060;1.0;0;0;1060;6;395350.0
4;2.0;2590;2.0;0;0;2590;10;1175000.0
3;2.5;2450;2.0;0;0;2450;8;660000.0
1;1.0;680;1.0;0;0;680;5;291970.0
3;2.5;1800;2.0;0;0;1800;8;495000.0
5;2.0;2020;1.5;0;0;2020;7;488000.0
5;1.75;1260;1.5;0;0;1260;7;650000.0
3;1.75;1440;1.0;0;0;1440;8;409000.0
3;3.0;2470;2.0;0;180;2290;9;660000.0
4;2.5;2570;2.0;0;0;2570;9;715000.0
4;2.5;3216;2.0;0;0;3216;9;498445.0
4;1.0;2180;1.5;0;0;2180;7;359000.0
5;3.25;3910;2.0;0;1200;2710;9;470000.0
3;1.0;1000;1.0;0;0;1000;6;220000.0
3;1.5;1930;1.0;0;430;1500;7;475000.0
5;1.75;1890;1.5;0;800;1090;7;523460.0
4;2.5;1700;2.0;0;0;1700;8;225000.0
3;2.5;1510;2.5;0;180;1330;8;453000.0
3;1.5;1830;1.0;0;820;1010;7;505000.0
3;2.5;1150;3.0;0;0;1150;7;288000.0
3;1.75;1480;1.0;0;0;1480;7;234000.0
4;4.0;4090;2.0;0;0;4090;11;1035000.0
3;1.0;1200;1.0;0;0;1200;6;146300.0
4;1.5;1370;1.0;0;470;900;7;190848.0
4;2.75;2250;1.0;0;930;1320;8;260000.0
2;1.0;900;1.0;0;0;900;7;325000.0
3;1.75;1520;1.0;0;350;1170;7;295000.0
3;3.0;3530;2.0;0;0;3530;10;600000.0
4;1.5;1440;1.0;0;480;960;7;589500.0
3;1.75;1790;1.0;0;0;1790;7;382000.0
4;1.0;2370;1.5;0;800;1570;7;399888.0
3;2.5;2860;2.0;0;0;2860;9;1010000.0
2;1.5;960;2.0;0;40;920;8;450000.0
5;3.5;2390;2.0;0;0;2390;7;267500.0
3;3.25;1600;3.0;0;0;1600;8;392500.0
3;2.5;1580;2.0;0;570;1010;8;525000.0
4;1.75;2280;1.0;0;1000;1280;7;312500.0
3;1.0;1160;1.0;0;0;1160;7;330000.0
4;3.5;3200;2.0;0;700;2500;9;735000.0
3;1.75;1290;1.0;0;0;1290;7;163000.0
4;3.0;2800;2.0;0;0;2800;8;457000.0
4;2.25;1940;1.0;0;580;1360;7;322000.0
2;1.75;1390;1.0;0;0;1390;8;216500.0
4;2.25;2200;2.0;0;0;2200;8;515000.0
3;3.0;2490;2.0;0;700;1790;8;1385000.0
4;1.75;1950;1.0;1;800;1150;7;700000.0
3;1.75;1150;1.0;0;0;1150;7;339000.0
3;2.5;1970;2.0;0;0;1970;8;509950.0
2;0.75;660;1.0;0;0;660;4;100000.0
3;2.25;1670;1.0;0;480;1190;7;252000.0
3;1.0;1200;1.5;0;0;1200;6;204000.0
1;1.0;1310;1.5;0;0;1310;6;575000.0
4;2.75;2620;1.5;0;900;1720;9;978000.0
1;0.75;840;1.5;0;0;840;6;224000.0
5;3.25;4320;2.0;0;0;4320;12;1600000.0
4;2.0;1960;1.0;0;800;1160;7;250000.0
4;2.75;3080;2.0;0;0;3080;9;550000.0
4;2.5;2680;2.0;0;0;2680;8;379950.0
4;4.5;3720;2.0;0;0;3720;10;960000.0
4;2.5;1594;1.0;0;506;1088;7;269000.0
5;1.75;1850;1.5;0;90;1760;6;315000.0
2;1.0;590;1.5;0;0;590;5;398000.0
4;3.0;2780;1.5;0;1070;1710;7;675000.0
4;1.0;1430;1.5;0;0;1430;5;275000.0
3;1.0;1690;1.0;0;0;1690;7;400000.0
3;2.5;2500;2.0;0;0;2500;9;565000.0
1;1.0;790;1.0;0;0;790;6;350000.0
3;2.5;1920;2.0;0;0;1920;7;380600.0
3;1.75;1890;1.0;0;660;1230;7;385000.0
4;2.5;2100;2.0;0;0;2100;8;333000.0
4;1.75;1760;1.0;0;0;1760;8;320000.0
5;2.5;2180;1.0;0;980;1200;7;425000.0
3;1.0;1060;1.0;0;150;910;7;450000.0
3;2.5;2100;2.0;0;0;2100;7;277950.0
3;2.5;1580;2.0;0;0;1580;8;375000.0
3;1.75;1510;1.0;0;0;1510;7;374000.0
4;2.25;2020;2.0;0;0;2020;7;599500.0
5;2.25;1950;1.0;0;820;1130;7;262500.0
5;2.0;2360;1.0;0;0;2360;7;355500.0
3;1.0;1060;1.0;0;0;1060;7;420000.0
3;1.0;1670;1.0;0;640;1030;7;282000.0
2;1.0;1000;1.0;0;200;800;6;257000.0
4;2.5;2250;2.0;0;0;2250;8;585000.0
3;3.25;1510;2.0;0;280;1230;8;465000.0
2;1.0;570;1.0;0;0;570;6;260000.0
3;1.0;1160;1.0;0;0;1160;7;325000.0
4;1.75;1240;1.5;0;0;1240;7;520000.0
4;2.25;1830;2.0;0;80;1750;8;1250000.0
4;2.5;2120;1.0;0;670;1450;8;550000.0
2;1.0;1390;1.0;0;0;1390;7;185000.0
4;2.5;3310;2.0;0;0;3310;9;838000.0
3;1.5;1300;1.0;0;400;900;7;226500.0
3;1.5;1220;1.5;0;0;1220;6;415000.0
4;3.0;3230;2.0;0;0;3230;9;950000.0
3;2.25;2440;2.0;0;350;2090;8;485000.0
4;2.5;2500;1.0;0;910;1590;8;450000.0
3;2.0;1540;1.0;0;420;1120;7;385500.0
3;2.5;1350;1.0;0;0;1350;7;600000.0
3;1.75;1670;1.0;0;0;1670;7;245000.0
3;1.75;1740;1.0;0;0;1740;7;245000.0
5;2.25;2200;1.0;0;1100;1100;7;268450.0
3;1.0;1040;1.0;0;0;1040;7;217500.0
3;1.75;2210;1.0;0;650;1560;8;685000.0
4;2.5;2650;2.0;0;0;2650;8;702000.0
3;2.0;1450;1.0;0;0;1450;7;230000.0
2;1.0;920;1.0;0;0;920;6;202000.0
4;2.0;1590;1.5;0;0;1590;7;414050.0
4;2.5;3030;2.0;0;1010;2020;8;471000.0
3;1.75;1810;1.0;0;570;1240;7;430000.0
3;1.75;1900;1.5;0;790;1110;7;615000.0
3;2.0;2570;1.5;0;0;2570;8;670000.0
2;2.25;1570;2.0;0;290;1280;9;500000.0
7;6.75;7480;2.0;0;2400;5080;11;800000.0
4;2.25;2900;2.0;0;910;1990;7;630000.0
3;2.25;1540;3.0;0;0;1540;8;565000.0
3;2.25;1830;1.0;0;480;1350;8;583000.0
3;2.25;1780;2.0;0;240;1540;8;675000.0
3;1.75;1490;1.0;0;430;1060;7;465000.0
4;2.5;3780;2.0;0;0;3780;9;962800.0
6;5.0;2732;2.0;0;0;2732;7;343000.0
3;2.5;2540;2.0;0;0;2540;8;347500.0
4;2.5;2740;2.0;0;0;2740;8;483500.0
3;1.0;2280;1.0;0;1030;1250;8;850000.0
4;2.5;2040;2.0;0;0;2040;8;575000.0
3;2.25;2180;1.0;0;520;1660;8;910000.0
3;1.5;1050;1.0;0;0;1050;6;195000.0
3;2.5;3240;2.0;0;0;3240;10;800000.0
3;1.75;1820;1.0;0;480;1340;7;422800.0
2;2.25;1460;2.0;0;0;1460;8;309950.0
3;1.0;1410;1.0;0;430;980;6;410000.0
3;1.0;1240;1.5;0;0;1240;6;221000.0
3;1.5;1390;1.0;0;0;1390;7;425000.0
3;1.5;1020;1.0;0;0;1020;7;255000.0
4;2.5;2560;2.0;0;0;2560;9;838000.0
5;2.0;2590;1.0;0;1250;1340;7;480000.0
4;2.5;2020;1.5;0;0;2020;6;319950.0
2;1.0;1570;1.5;0;0;1570;8;998500.0
3;2.0;1010;1.0;0;0;1010;8;390000.0
2;1.75;1430;1.0;0;0;1430;7;350000.0
3;2.5;2620;2.0;0;0;2620;9;557500.0
3;1.75;1740;1.0;0;0;1740;7;340000.0
3;2.5;1560;2.0;0;0;1560;7;254000.0
4;2.5;3650;2.0;0;0;3650;10;861111.0
9;3.0;3680;2.0;0;850;2830;7;700000.0
4;3.5;2530;2.0;0;680;1850;8;382000.0
4;2.5;2181;2.0;0;0;2181;8;340000.0
3;2.5;3230;1.0;0;1130;2100;8;499950.0
3;2.25;2200;2.0;0;0;2200;8;285167.0
4;2.5;1930;1.0;0;0;1930;9;465000.0
3;2.0;1310;1.0;0;530;780;7;428000.0
3;2.0;1510;1.0;0;280;1230;7;430000.0
3;2.0;1410;1.0;0;670;740;7;517950.0
4;1.75;1700;1.5;0;360;1340;7;400000.0
3;2.5;3600;1.0;0;1290;2310;9;1355000.0
6;4.5;3900;2.0;0;1030;2870;8;650000.0
2;1.0;790;1.0;0;0;790;6;245500.0
3;1.75;1860;1.0;0;0;1860;7;275000.0
4;2.25;2470;1.0;0;870;1600;7;618000.0
2;1.0;830;1.0;0;0;830;6;160000.0
3;1.75;1920;1.0;0;850;1070;7;615000.0
3;1.0;1800;1.0;0;760;1040;7;610000.0
3;1.0;1510;1.0;0;0;1510;7;199000.0
5;1.75;2590;1.0;0;840;1750;7;334000.0
4;2.0;1810;1.0;0;0;1810;7;295000.0
5;2.5;3220;2.0;0;0;3220;8;315000.0
1;1.0;790;1.0;0;0;790;6;248000.0
4;2.75;4020;2.0;0;1190;2830;10;1950000.0
4;2.75;3320;2.0;0;1100;2220;8;665000.0
5;2.75;3460;2.0;0;0;3460;9;858450.0
3;1.0;960;1.0;0;0;960;7;215000.0
4;2.0;1610;1.0;0;420;1190;7;526000.0
3;2.0;1890;1.0;0;0;1890;8;690000.0
4;3.5;4560;1.0;0;2330;2230;12;1200000.0
3;1.0;1520;1.0;0;400;1120;7;250000.0
4;2.5;1840;2.0;0;0;1840;7;360000.0
3;2.5;1730;2.0;0;0;1730;8;435000.0
4;2.5;2470;2.0;0;0;2470;8;332000.0
3;1.0;1260;1.0;0;540;720;6;342000.0
4;2.5;2789;2.0;0;0;2789;7;272000.0
4;2.0;2340;1.5;0;0;2340;6;220000.0
3;3.0;2060;2.0;0;0;2060;8;800000.0
3;3.0;2340;2.0;0;0;2340;8;427874.0
3;2.75;1820;2.0;0;0;1820;8;417000.0
3;2.25;1200;2.0;0;0;1200;7;342000.0
1;0.75;1040;1.0;0;460;580;7;272000.0
3;1.75;1840;1.0;0;400;1440;7;325000.0
3;1.0;1260;1.0;0;0;1260;7;188200.0
4;1.75;2060;1.0;0;900;1160;8;647500.0
2;2.0;1350;1.0;0;0;1350;8;382000.0
3;2.0;1440;1.0;0;590;850;7;380000.0
3;1.0;1310;1.0;0;0;1310;7;553000.0
4;2.5;2040;2.0;0;0;2040;7;475000.0
5;3.5;3500;2.0;0;0;3500;10;815000.0
4;2.75;2030;1.0;0;0;2030;7;302000.0
3;1.75;2040;2.0;0;680;1360;7;720000.0
3;2.5;1600;2.0;0;0;1600;8;330000.0
3;1.0;1050;1.0;0;0;1050;7;350000.0
4;2.0;2120;1.0;0;1060;1060;7;455000.0
3;1.5;1180;1.0;0;0;1180;8;816000.0
2;2.25;1550;2.0;0;0;1550;8;348500.0
3;1.0;1250;1.0;0;0;1250;7;164808.0
3;2.5;1890;2.0;0;0;1890;8;490000.0
4;4.5;4060;2.0;0;0;4060;10;530000.0
4;1.75;1760;1.0;0;880;880;7;527950.0
4;1.0;1320;1.0;0;0;1320;6;250000.0
2;2.0;1870;1.0;0;0;1870;8;572000.0
3;2.5;2250;2.0;0;0;2250;9;615000.0
6;3.25;4250;1.0;0;2100;2150;10;465000.0
3;1.0;1030;1.0;0;0;1030;7;229000.0
2;2.5;1390;2.0;0;260;1130;8;635000.0
4;2.75;2600;2.0;0;640;1960;8;749950.0
3;1.5;1560;1.0;0;0;1560;7;273500.0
3;2.5;2620;2.0;0;0;2620;8;427000.0
3;1.0;1360;1.0;0;0;1360;7;355000.0
3;2.0;1920;1.0;0;0;1920;9;340000.0
3;1.75;1770;1.0;0;0;1770;8;215000.0
6;2.5;3610;2.0;0;400;3210;8;610000.0
3;1.75;1520;1.0;0;700;820;7;460000.0
4;2.5;3030;2.0;0;0;3030;9;557865.0
3;2.75;3410;1.5;0;0;3410;8;500000.0
4;3.75;4490;2.0;0;0;4490;12;1680000.0
3;1.5;1780;1.0;0;0;1780;7;246000.0
3;2.0;1090;1.0;0;150;940;7;158000.0
4;3.5;4680;2.0;0;1320;3360;10;1160000.0
4;3.0;2460;1.0;0;760;1700;7;570000.0
3;1.75;1320;1.0;0;0;1320;7;199000.0
4;1.75;1720;1.0;0;300;1420;8;580000.0
4;1.75;2120;1.0;0;930;1190;7;582000.0
3;1.5;1860;1.0;0;0;1860;7;217000.0
3;1.0;1640;1.0;0;600;1040;7;170500.0
3;1.75;2010;1.0;0;510;1500;8;335000.0
3;2.5;1690;1.0;0;0;1690;7;460000.0
4;2.75;3250;2.0;0;0;3250;9;800000.0
4;2.5;2570;2.0;0;0;2570;9;625000.0
2;1.0;1220;1.0;0;0;1220;7;300000.0
5;3.5;3990;2.0;0;1080;2910;8;740000.0
5;2.25;2520;2.0;0;0;2520;9;610000.0
2;1.0;770;1.0;0;0;770;6;385000.0
3;1.75;1400;1.5;0;0;1400;6;249000.0
3;1.75;1620;1.0;0;700;920;7;514000.0
3;2.5;2040;2.0;0;0;2040;8;325900.0
4;4.0;2850;2.0;0;730;2120;8;620000.0
2;1.0;840;2.0;0;0;840;7;306500.0
3;1.5;1160;1.0;0;0;1160;7;262500.0
1;1.0;900;1.0;0;0;900;6;152900.0
3;2.25;1900;1.0;0;510;1390;8;280000.0
3;1.5;1890;1.5;0;0;1890;7;651000.0
3;2.5;1300;2.0;0;0;1300;8;374990.0
3;2.75;2600;1.5;0;0;2600;8;415000.0
5;4.75;3940;2.0;0;710;3230;10;1695000.0
3;1.5;1320;1.0;0;0;1320;7;255000.0
4;2.5;3080;2.5;0;0;3080;8;750000.0
3;2.25;1720;1.0;0;280;1440;7;286900.0
3;3.25;1480;2.0;0;300;1180;8;320000.0
3;3.0;2240;2.0;0;0;2240;7;323500.0
3;2.5;2260;1.0;0;0;2260;6;367000.0
4;1.75;1530;1.5;0;0;1530;7;269900.0
4;2.25;1800;1.0;0;360;1440;7;160000.0
3;2.25;2080;1.5;0;530;1550;7;284000.0
4;2.5;2370;2.0;0;0;2370;8;495000.0
2;1.0;740;1.0;0;0;740;6;250000.0
3;1.0;1980;1.0;0;700;1280;7;207000.0
2;2.0;1490;3.0;0;0;1490;9;700000.0
4;3.0;2110;2.0;0;400;1710;9;585000.0
3;1.75;1580;1.0;0;380;1200;7;315000.0
4;2.5;2560;2.0;0;0;2560;8;399500.0
4;2.5;2360;1.0;0;380;1980;8;633000.0
2;1.0;870;1.0;0;0;870;7;334850.0
3;1.0;1150;1.0;0;0;1150;7;227500.0
3;1.75;1830;1.0;0;680;1150;7;550000.0
3;2.0;1910;1.0;0;500;1410;7;390000.0
4;2.5;3690;2.0;0;0;3690;10;780000.0
3;1.0;1430;1.5;0;420;1010;6;235000.0
3;1.75;1330;1.0;0;0;1330;7;236000.0
4;1.5;1480;1.0;0;0;1480;6;283000.0
4;2.25;2200;1.0;0;950;1250;7;425000.0
4;1.75;1870;1.0;0;200;1670;8;700000.0
5;2.75;2040;1.0;0;840;1200;7;449500.0
3;2.5;2200;2.0;0;0;2200;8;525000.0
4;2.0;2350;2.0;0;0;2350;8;659000.0
4;2.25;2330;1.0;0;880;1450;8;615000.0
5;1.75;2510;1.5;0;500;2010;8;860000.0
3;2.5;1770;2.0;0;0;1770;9;593567.0
3;2.5;1930;1.0;0;600;1330;7;375000.0
4;2.5;2680;2.0;0;0;2680;8;515000.0
2;1.0;830;1.0;0;0;830;7;350000.0
5;2.5;2780;2.0;0;0;2780;8;550000.0
3;1.0;1140;1.0;0;0;1140;6;158000.0
3;2.25;1760;1.0;0;600;1160;7;270000.0
3;2.25;1970;2.0;0;290;1680;8;415000.0
3;2.5;3090;2.0;0;0;3090;8;659000.0
3;1.75;2340;1.0;0;0;2340;8;780000.0
3;2.0;2070;1.5;0;400;1670;7;662500.0
5;3.5;3510;2.0;0;810;2700;10;1250000.0
4;3.5;4200;2.0;0;560;3640;12;1460000.0
3;2.0;1170;1.0;0;0;1170;6;335000.0
3;2.25;1960;1.0;0;560;1400;8;285750.0
4;3.0;2300;2.0;0;0;2300;7;224000.0
4;2.5;2480;2.0;0;0;2480;9;840000.0
3;1.5;1650;1.0;0;560;1090;7;219950.0
3;2.5;1489;2.0;0;0;1489;7;255900.0
4;2.75;2790;2.0;0;0;2790;10;765000.0
3;2.75;3610;1.5;1;480;3130;8;425000.0
2;1.0;980;2.0;0;0;980;8;447000.0
3;2.5;1600;2.0;0;0;1600;8;400000.0
4;2.5;3360;2.0;0;0;3360;10;765000.0
3;2.0;2570;1.0;0;600;1970;9;660000.0
4;2.5;2770;2.0;0;0;2770;9;675750.0
4;3.5;4010;2.0;0;0;4010;10;1735000.0
4;2.5;2020;1.5;0;540;1480;7;542000.0
3;1.75;1370;1.0;0;0;1370;7;247200.0
4;2.25;1650;1.0;0;0;1650;8;550000.0
4;2.5;2390;2.0;0;0;2390;8;278226.0
4;1.75;1590;2.0;0;0;1590;7;372500.0
4;1.75;1550;1.0;0;0;1550;7;229900.0
2;1.0;1120;1.0;0;0;1120;6;325000.0
4;2.75;2600;1.0;0;1300;1300;8;855000.0
4;2.5;2610;2.0;0;0;2610;8;337000.0
3;2.0;1610;1.0;0;520;1090;7;545000.0
3;1.75;1720;1.0;0;580;1140;7;450000.0
3;1.75;1690;2.0;0;310;1380;8;380000.0
3;2.5;2390;2.0;0;170;2220;8;629800.0
4;1.75;2290;1.0;0;1000;1290;7;435000.0
3;1.75;2000;1.0;0;0;2000;6;443950.0
4;2.75;2140;1.0;0;950;1190;7;625000.0
3;2.5;1750;2.0;0;0;1750;8;437000.0
3;1.75;1720;1.5;0;0;1720;8;420000.0
3;1.5;1450;2.0;0;0;1450;7;274000.0
4;1.5;1970;1.5;0;0;1970;7;374950.0
4;1.0;1490;1.5;0;0;1490;7;570000.0
3;3.25;1770;3.0;0;0;1770;8;401000.0
5;2.25;2070;1.0;0;990;1080;7;400000.0
3;1.0;1050;1.0;0;0;1050;6;350000.0
4;2.5;1840;2.0;0;0;1840;7;190000.0
3;3.5;1900;2.0;0;470;1430;8;431500.0
10;2.0;3610;2.0;0;600;3010;7;650000.0
4;2.75;2400;2.0;0;0;2400;8;590000.0
2;1.5;1000;2.0;0;70;930;7;377000.0
3;2.5;1970;1.0;0;0;1970;9;599950.0
3;2.0;1290;1.0;0;0;1290;7;237000.0
2;1.5;1170;3.0;0;0;1170;8;405000.0
2;1.0;900;1.0;0;0;900;7;470000.0
2;1.0;780;1.0;0;0;780;6;319000.0
4;2.75;2450;2.0;0;0;2450;8;735000.0
6;4.0;5310;2.0;0;1710;3600;10;1050000.0
3;1.75;1870;1.0;0;0;1870;8;811000.0
4;2.5;1810;2.0;0;0;1810;8;295000.0
4;2.5;1940;2.0;0;0;1940;7;278000.0
3;2.5;1540;2.0;0;240;1300;7;384000.0
3;2.5;2680;2.0;0;0;2680;8;630000.0
3;2.0;2300;1.0;0;1150;1150;8;650000.0
4;2.5;4250;2.0;0;990;3260;9;1339000.0
2;1.0;750;1.0;0;0;750;5;250000.0
5;3.0;3880;2.0;0;0;3880;7;430000.0
3;3.25;2660;2.0;0;490;2170;9;915000.0
3;1.5;1420;1.0;0;0;1420;7;413107.0
3;2.0;1410;1.0;0;0;1410;7;365500.0
3;2.0;2250;1.0;0;0;2250;9;998800.0
3;2.5;1820;1.0;0;600;1220;7;239975.0
4;4.0;5320;2.0;0;0;5320;11;1062500.0
3;1.75;1660;1.0;0;420;1240;7;650000.0
4;3.25;3410;2.0;0;0;3410;10;1575000.0
5;2.5;2400;2.0;0;0;2400;7;338000.0
3;3.0;1370;3.0;0;0;1370;8;327000.0
4;1.75;2240;1.0;0;1120;1120;7;344950.0
5;2.5;2880;2.0;0;0;2880;8;362000.0
3;1.0;1470;1.0;0;430;1040;7;290000.0
3;2.0;1980;3.0;0;0;1980;8;435000.0
3;2.5;2010;2.0;0;0;2010;7;279000.0
4;2.25;2440;1.0;0;560;1880;7;650000.0
3;1.0;1000;1.5;0;0;1000;6;230000.0
3;1.5;1520;1.0;0;500;1020;7;380000.0
3;2.5;2510;2.0;0;0;2510;9;820000.0
4;3.5;4370;2.0;0;1590;2780;8;473000.0
3;1.0;1220;1.0;0;0;1220;6;253500.0
3;1.5;1250;1.0;0;0;1250;7;455000.0
3;2.5;1810;2.0;0;460;1350;7;503500.0
4;1.75;2180;1.0;0;0;2180;9;875000.0
4;2.5;3230;2.0;0;710;2520;9;480000.0
3;1.0;1080;1.0;0;0;1080;7;275000.0
4;2.0;2260;1.0;0;1130;1130;7;525000.0
4;2.5;3770;2.0;0;0;3770;11;1038000.0
3;2.5;1700;2.0;0;0;1700;7;403000.0
3;2.5;2510;1.0;0;600;1910;7;624000.0
4;1.75;1920;1.0;0;0;1920;7;480000.0
2;1.0;820;1.0;0;0;820;7;532500.0
3;2.5;2750;2.0;0;0;2750;9;375000.0
4;2.75;1750;1.5;0;0;1750;8;750000.0
3;2.5;1440;1.0;0;0;1440;8;515000.0
3;1.75;1680;1.5;0;0;1680;7;540000.0
2;2.0;1120;2.0;0;360;760;8;380000.0
5;2.25;2400;1.0;0;1200;1200;7;650000.0
3;2.75;2500;2.0;0;130;2370;9;990000.0
4;2.75;3600;2.0;0;990;2610;9;970000.0
3;1.0;1610;1.5;0;0;1610;7;440000.0
4;2.5;1960;1.0;0;740;1220;7;355950.0
3;1.75;1840;1.0;0;600;1240;7;269500.0
4;2.5;2770;2.0;0;0;2770;9;907500.0
2;1.0;1450;1.0;0;0;1450;7;350500.0
4;3.25;4350;2.0;0;1480;2870;8;472000.0
2;1.0;1090;1.0;0;0;1090;7;196700.0
4;2.75;2290;2.0;0;120;2170;7;1003000.0
3;2.5;2220;2.0;0;210;2010;10;654000.0
6;4.5;4230;2.0;0;1870;2360;8;1465000.0
4;2.25;2140;2.0;0;0;2140;7;245000.0
4;2.25;2060;1.0;0;860;1200;7;264500.0
3;1.75;2660;1.0;0;1330;1330;8;467000.0
3;3.0;1260;3.0;0;0;1260;8;342000.0
4;3.25;2740;2.5;0;0;2740;9;705000.0
4;2.5;3052;2.0;0;0;3052;8;425000.0
4;3.25;2590;3.0;0;0;2590;9;760000.0
2;2.5;1320;2.0;0;330;990;8;499950.0
3;1.75;2160;1.0;0;900;1260;8;670000.0
7;3.5;4640;2.0;0;1780;2860;11;1950000.0
3;1.75;1960;1.0;0;0;1960;7;247500.0
2;1.0;1200;1.0;0;600;600;6;395000.0
5;2.5;2600;2.0;0;0;2600;9;775000.0
3;2.0;2380;2.0;0;270;2110;8;550000.0
3;2.0;1220;1.0;0;0;1220;7;415500.0
4;1.75;2400;1.5;0;900;1500;7;389000.0
4;2.5;2700;2.0;0;0;2700;9;652500.0
3;2.0;2710;1.5;0;830;1880;8;805000.0
3;1.0;1620;1.0;0;0;1620;6;345000.0
3;4.0;4200;2.0;0;600;3600;11;2225000.0
4;2.5;2240;1.0;0;870;1370;7;220000.0
5;4.0;4780;2.0;0;0;4780;11;1640000.0
3;2.25;2100;1.0;0;770;1330;8;483000.0
3;1.75;1650;3.0;0;0;1650;8;599000.0
3;1.75;1880;1.0;0;0;1880;8;681000.0
4;5.5;6550;1.0;0;1150;5400;11;1500000.0
4;2.5;2030;2.0;0;0;2030;8;304500.0
4;2.25;1930;1.5;0;390;1540;8;689888.0
2;1.0;1060;1.0;0;0;1060;5;111300.0
2;1.5;1220;1.5;0;0;1220;8;168000.0
3;1.75;1470;1.0;0;0;1470;7;490000.0
3;1.75;1220;1.0;0;0;1220;7;333500.0
3;3.25;1340;2.0;0;0;1340;7;176000.0
4;2.75;3370;1.0;0;1400;1970;9;1135000.0
3;1.5;1750;1.0;0;0;1750;7;475000.0
3;2.5;2040;2.0;0;0;2040;8;490000.0
3;2.5;1660;2.0;0;0;1660;7;284000.0
1;1.0;600;1.0;0;0;600;6;229000.0
3;1.75;1960;1.0;0;980;980;7;363000.0
5;3.5;4800;2.0;0;1320;3480;11;1350000.0
4;2.0;1800;1.0;0;0;1800;7;305000.0
7;4.75;5310;2.0;0;1660;3650;10;2300000.0
3;1.0;1060;1.0;0;0;1060;8;420000.0
3;2.5;2849;2.0;0;0;2849;10;798000.0
5;2.75;2870;2.0;0;0;2870;9;730000.0
2;1.75;1760;1.0;0;820;940;7;605000.0
3;1.75;1730;1.0;0;0;1730;8;400000.0
3;2.0;2290;1.0;0;620;1670;9;565000.0
3;2.0;1530;1.0;0;0;1530;7;570000.0
2;2.5;2210;1.0;0;0;2210;8;802000.0
3;1.0;870;1.0;0;0;870;6;217000.0
3;1.75;1820;1.0;0;570;1250;7;420000.0
3;2.5;2130;2.0;0;0;2130;8;546500.0
2;2.0;1660;1.0;0;540;1120;7;601150.0
2;2.0;1090;3.0;0;0;1090;8;427500.0
3;1.75;1320;1.0;0;0;1320;8;475000.0
2;1.0;1130;1.0;0;0;1130;6;207000.0
3;1.75;1520;1.0;0;0;1520;8;249000.0
3;1.75;1480;1.5;0;0;1480;7;500000.0
4;2.5;1710;2.0;0;0;1710;7;282900.0
4;2.25;2130;2.0;0;0;2130;8;671500.0
3;2.0;2220;1.0;0;0;2220;7;585000.0
3;2.0;1490;2.0;0;0;1490;6;437500.0
3;1.75;1020;1.5;0;0;1020;7;360000.0
5;2.5;2390;1.0;0;1120;1270;7;358000.0
2;1.0;620;1.0;0;0;620;6;255000.0
4;2.5;3070;2.0;0;400;2670;10;1715000.0
4;1.0;2170;1.0;0;0;2170;7;565000.0
4;2.25;3180;2.0;0;0;3180;10;725000.0
3;1.0;1720;1.0;0;0;1720;7;399950.0
5;1.0;1410;1.0;0;0;1410;7;230000.0
2;1.0;1120;1.5;0;0;1120;7;524000.0
3;1.5;2170;1.0;1;1040;1130;10;1150000.0
3;1.0;1330;1.0;0;430;900;7;553000.0
4;2.0;1450;1.0;0;0;1450;7;205000.0
3;2.5;1413;2.0;0;0;1413;8;286800.0
4;1.75;2000;1.0;0;610;1390;7;335000.0
4;2.25;2350;1.0;0;920;1430;8;555000.0
3;2.5;1860;2.0;0;0;1860;8;309620.0
4;2.5;2280;2.0;0;0;2280;8;565000.0
3;3.5;3600;2.0;0;0;3600;8;660000.0
3;3.25;2200;2.0;0;490;1710;7;525000.0
3;1.0;1530;1.0;0;0;1530;7;252000.0
3;2.5;2200;2.0;0;0;2200;7;315000.0
4;2.25;2770;2.0;0;330;2440;9;950000.0
2;1.5;1270;1.0;0;0;1270;7;275000.0
3;1.75;2110;1.0;0;730;1380;7;288250.0
5;2.75;2500;1.0;0;1250;1250;7;530000.0
5;3.5;3080;2.0;0;770;2310;8;455000.0
4;2.25;3270;1.0;0;1270;2000;10;987500.0
4;2.5;2570;2.0;0;0;2570;9;1100000.0
6;3.5;3830;2.0;0;0;3830;9;710000.0
4;2.5;2480;1.0;0;1010;1470;7;495000.0
4;2.5;2060;2.0;0;0;2060;8;242550.0
3;1.75;1770;1.0;0;600;1170;7;502550.0
4;2.5;2500;2.0;0;0;2500;8;372000.0
2;2.0;1040;1.0;0;190;850;6;160000.0
4;3.0;3510;2.0;0;0;3510;9;970000.0
4;2.5;2300;2.0;0;0;2300;8;380000.0
3;2.5;4570;2.0;0;0;4570;12;1038000.0
3;2.25;1750;1.0;0;480;1270;8;382000.0
3;1.0;1690;1.0;0;0;1690;7;215000.0
2;1.0;830;1.0;0;0;830;6;210000.0
4;3.25;3760;1.5;0;1360;2400;9;1580000.0
3;2.5;2000;3.0;0;0;2000;8;755000.0
3;1.5;1240;1.0;0;0;1240;7;523000.0
3;1.0;880;1.0;0;0;880;7;230000.0
4;2.0;1420;1.0;0;0;1420;7;400000.0
3;2.25;1420;1.0;0;260;1160;7;364000.0
3;1.0;1430;1.0;0;0;1430;6;213950.0
4;1.5;1960;1.5;0;0;1960;7;442000.0
4;1.75;1880;1.0;0;870;1010;7;423000.0
4;4.25;4250;2.0;0;1380;2870;10;2450000.0
3;2.5;2010;1.0;0;560;1450;9;960000.0
3;1.5;2120;1.0;0;900;1220;8;440000.0
2;1.5;1150;2.0;0;0;1150;7;300000.0
4;2.25;2820;1.5;0;1020;1800;9;1075000.0
4;2.25;1990;1.0;0;0;1990;8;365000.0
2;1.0;1500;1.0;0;310;1190;7;245000.0
5;1.75;1580;1.0;0;600;980;6;265000.0
3;2.0;1550;1.5;0;0;1550;8;537000.0
3;2.5;1780;2.0;0;700;1080;8;660000.0
3;2.5;1260;2.0;0;420;840;8;353500.0
4;3.75;4490;2.0;0;1400;3090;10;1715000.0
2;1.0;1070;1.0;0;0;1070;7;335000.0
4;2.5;2350;2.0;0;0;2350;8;270000.0
3;1.5;1560;1.0;0;340;1220;7;525000.0
3;1.0;1410;1.0;0;430;980;7;225000.0
4;2.5;3020;2.0;0;0;3020;9;790000.0
5;2.75;2190;1.0;0;820;1370;7;446000.0
3;2.5;2540;2.0;0;0;2540;7;300000.0
3;2.25;2430;1.5;0;530;1900;8;365000.0
4;2.0;3090;1.0;0;1500;1590;7;595000.0
3;1.75;1660;1.0;0;0;1660;7;331292.0
3;1.0;1000;1.0;0;0;1000;7;265000.0
4;2.5;2630;2.0;0;0;2630;8;575000.0
4;2.5;2300;2.0;0;0;2300;9;560000.0
3;2.5;2010;2.0;0;620;1390;8;550000.0
4;2.0;1760;1.0;0;0;1760;8;690000.0
3;1.75;2090;1.0;0;890;1200;7;489000.0
2;2.25;1950;1.0;0;600;1350;8;438000.0
3;1.0;1490;1.0;0;370;1120;7;258000.0
2;2.5;2320;1.0;0;0;2320;8;694000.0
4;2.5;2970;2.0;0;0;2970;9;715000.0
3;1.0;1170;2.0;0;0;1170;5;315000.0
3;1.75;1340;1.0;0;460;880;7;315000.0
3;1.0;1290;1.0;0;310;980;7;372220.0
4;2.75;3460;1.0;0;1680;1780;9;1088890.0
4;2.5;1620;2.0;0;0;1620;7;385000.0
5;2.5;2550;2.0;0;0;2550;7;465000.0
3;2.5;3570;1.0;0;1170;2400;8;935000.0
4;2.5;2310;2.0;0;0;2310;8;597750.0
4;1.75;2060;1.0;0;0;2060;8;640000.0
3;1.75;1720;1.0;0;860;860;7;340000.0
3;2.75;1820;2.0;0;0;1820;7;488500.0
3;2.25;1660;1.0;0;550;1110;7;425000.0
3;2.5;2550;2.0;0;0;2550;9;695000.0
2;1.0;970;1.0;0;0;970;7;345000.0
2;1.0;1100;1.0;0;0;1100;7;300000.0
4;2.5;2100;2.0;0;700;1400;7;595000.0
3;1.0;940;1.0;0;0;940;6;239000.0
5;2.25;3740;1.5;0;1500;2240;8;392000.0
3;2.75;2600;1.5;0;1000;1600;8;805000.0
3;2.5;2120;2.0;0;0;2120;8;475226.0
3;1.0;1290;1.0;0;0;1290;7;362000.0
4;2.5;2380;2.0;0;0;2380;10;782000.0
3;3.0;2330;2.0;0;410;1920;9;453000.0
5;2.25;3410;2.0;0;880;2530;10;815000.0
2;2.5;1380;3.0;0;0;1380;9;549000.0
3;0.75;1080;1.0;0;0;1080;5;205000.0
3;1.0;980;1.0;0;0;980;7;133000.0
3;1.5;2260;1.0;0;1060;1200;7;440000.0
4;1.75;1820;1.0;0;630;1190;6;300000.0
3;2.0;1190;1.0;0;0;1190;7;200000.0
4;2.5;1880;2.0;0;0;1880;8;530200.0
5;2.5;3190;2.0;0;0;3190;9;865000.0
4;2.5;3400;2.0;0;0;3400;11;915000.0
4;2.25;2290;1.0;0;740;1550;8;571000.0
2;2.0;1500;3.0;0;0;1500;7;308625.0
3;2.25;1500;1.0;0;350;1150;7;230000.0
3;1.5;1810;1.5;0;500;1310;8;585000.0
3;1.0;1790;1.0;0;0;1790;6;225000.0
3;2.25;1140;3.0;0;0;1140;8;375000.0
3;1.0;2110;1.0;0;1000;1110;7;475300.0
6;3.25;2900;2.0;0;600;2300;8;696000.0
2;1.0;1000;1.0;0;0;1000;7;311300.0
2;1.0;1360;1.0;0;680;680;6;255000.0
4;2.5;3440;2.0;1;1270;2170;8;1950000.0
5;3.25;5270;2.0;0;1260;4010;10;1795000.0
4;2.75;2400;1.0;0;1230;1170;8;420000.0
4;1.75;2310;1.0;0;660;1650;7;319950.0
5;3.0;2460;1.0;0;620;1840;9;637000.0
3;1.0;1390;1.0;0;0;1390;7;199000.0
4;2.0;1400;2.0;0;0;1400;7;815000.0
4;2.75;2050;1.0;0;510;1540;8;528000.0
4;1.5;1650;1.5;0;0;1650;7;752000.0
3;2.75;1300;1.0;0;440;860;7;245000.0
4;3.25;3860;1.0;0;1230;2630;10;2135000.0
3;1.0;1790;1.0;0;0;1790;6;302100.0
3;2.5;2250;2.0;0;0;2250;8;792000.0
3;2.5;1720;2.0;0;0;1720;9;500000.0
2;1.5;1860;1.0;0;800;1060;7;510000.0
3;1.5;1210;1.0;0;0;1210;7;208000.0
3;2.5;2430;2.0;0;0;2430;7;342000.0
4;2.25;1990;2.0;0;0;1990;8;435000.0
3;2.5;3180;1.0;0;1370;1810;8;439000.0
4;2.75;2390;2.0;0;250;2140;7;799000.0
3;1.75;1650;1.0;0;0;1650;7;259500.0
3;2.5;2390;2.0;0;0;2390;7;349950.0
2;2.5;2630;2.0;0;0;2630;8;750000.0
2;1.5;1660;1.0;0;660;1000;7;410000.0
4;2.0;1780;1.0;0;880;900;7;325000.0
3;1.75;1390;1.0;0;0;1390;7;261350.0
3;2.0;1320;1.0;0;0;1320;7;256500.0
4;3.5;3170;2.0;0;830;2340;10;1125000.0
6;3.0;2400;2.0;0;0;2400;7;300000.0
2;1.0;1800;1.0;0;600;1200;7;390000.0
2;1.75;1710;2.0;0;380;1330;7;405000.0
3;1.0;1340;1.0;0;0;1340;7;206135.0
3;1.75;1760;1.0;0;600;1160;7;410000.0
3;1.75;1590;2.0;0;530;1060;8;465000.0
4;1.5;1920;1.0;0;0;1920;8;240000.0
2;1.0;920;1.0;0;0;920;7;400000.0
4;2.25;3380;1.0;0;1690;1690;8;470000.0
3;1.0;1440;1.0;0;0;1440;7;604000.0
5;2.5;2590;2.0;0;0;2590;8;779380.0
3;3.5;1420;2.0;0;240;1180;8;579950.0
4;3.0;3040;2.0;0;0;3040;10;691000.0
4;2.5;2700;1.0;0;1140;1560;8;300000.0
4;2.75;2730;2.0;0;0;2730;8;565000.0
2;1.0;1060;1.0;0;0;1060;7;570000.0
3;1.0;2000;1.0;0;320;1680;7;525000.0
2;1.0;1120;1.0;0;0;1120;7;450000.0
4;2.5;2170;1.0;0;600;1570;7;420000.0
2;1.5;1020;3.0;0;0;1020;8;441750.0
3;1.75;1570;1.0;0;0;1570;7;209950.0
4;2.75;2180;2.0;0;0;2180;8;571500.0
5;3.0;2500;1.0;0;950;1550;8;730000.0
4;3.0;2320;1.0;0;1060;1260;7;770000.0
4;2.75;2500;1.0;0;800;1700;8;950000.0
3;1.0;1170;1.0;0;0;1170;6;119500.0
2;1.0;770;1.0;0;0;770;6;176000.0
2;1.0;790;1.0;0;0;790;6;418500.0
4;1.5;1200;1.5;0;0;1200;6;178000.0
5;2.0;2960;1.0;0;1460;1500;7;800000.0
2;1.0;930;1.0;0;0;930;8;178500.0
3;2.5;2160;3.0;0;330;1830;8;585000.0
3;1.75;1660;1.0;0;0;1660;7;315000.0
4;1.75;1550;1.0;0;0;1550;7;557800.0
4;1.75;2040;1.0;0;1020;1020;7;551000.0
4;2.5;2700;2.0;0;0;2700;9;1200000.0
4;2.5;2755;2.0;0;0;2755;8;545000.0
3;2.25;2200;1.0;0;1080;1120;7;315000.0
3;2.5;2600;2.0;0;0;2600;8;355500.0
3;1.0;1190;1.0;0;160;1030;7;442000.0
4;1.75;1680;1.0;0;120;1560;7;275000.0
3;2.5;1830;2.0;0;0;1830;8;325000.0
2;1.0;720;1.0;0;0;720;6;205000.0
2;2.5;2390;1.0;0;0;2390;8;699950.0
5;2.0;1910;1.0;0;800;1110;6;230000.0
4;2.5;3560;2.0;0;0;3560;11;896000.0
4;4.5;4020;2.0;0;0;4020;10;1898000.0
3;2.75;1910;1.0;0;750;1160;7;441000.0
5;4.75;5305;2.0;0;1560;3745;11;2700000.0
4;3.5;5490;1.0;0;2580;2910;12;1785000.0
2;1.5;1070;2.0;0;70;1000;8;401750.0
3;2.25;1310;3.0;0;0;1310;8;514950.0
4;2.5;2940;2.0;0;0;2940;9;530000.0
5;2.5;4600;1.5;0;1000;3600;9;2408000.0
4;2.5;3960;2.0;0;0;3960;10;805000.0
3;1.5;1910;1.5;0;0;1910;7;247200.0
3;1.75;2020;1.0;0;0;2020;9;740000.0
1;1.0;890;1.5;0;0;890;7;362000.0
2;1.0;880;1.0;0;0;880;6;416000.0
3;1.0;1270;1.0;0;620;650;6;134000.0
5;2.5;4150;2.0;0;0;4150;10;930800.0
3;2.5;1805;2.0;0;0;1805;7;266000.0
4;3.0;3280;1.5;0;0;3280;7;458000.0
3;2.0;1360;1.5;0;0;1360;8;382000.0
4;3.5;4330;2.0;0;1100;3230;11;1700000.0
3;2.5;2880;2.0;0;0;2880;10;720000.0
3;2.5;1800;2.0;0;0;1800;8;517500.0
4;2.75;3770;2.0;0;1220;2550;8;940000.0
1;1.0;900;1.0;0;0;900;6;395000.0
3;1.0;1090;1.0;0;0;1090;7;406000.0
3;3.25;4340;2.0;0;1280;3060;11;2475000.0
2;1.0;780;1.0;0;0;780;5;78000.0
4;1.75;2100;1.0;0;820;1280;8;457000.0
5;1.5;2120;1.5;0;0;2120;7;290000.0
3;2.0;2880;1.5;0;800;2080;7;660000.0
4;2.25;1930;1.0;0;570;1360;7;280000.0
3;2.5;1690;2.0;0;0;1690;7;482500.0
3;2.5;2970;2.0;0;0;2970;9;820000.0
3;1.0;840;1.0;0;0;840;6;199990.0
3;2.5;2220;2.0;0;0;2220;8;382450.0
2;1.0;980;1.0;0;120;860;6;400000.0
6;4.5;3500;2.0;0;0;3500;7;682500.0
4;2.5;2650;2.0;0;0;2650;9;429000.0
4;2.25;2340;1.0;0;0;2340;9;995000.0
2;2.0;1370;1.0;0;420;950;8;585000.0
3;3.0;2330;2.5;0;380;1950;8;669950.0
3;1.5;1590;1.0;0;500;1090;7;284850.0
4;1.0;1460;1.5;0;0;1460;7;320000.0
6;3.0;3030;1.0;0;1360;1670;8;624500.0
3;1.75;1700;1.0;0;500;1200;8;502775.0
3;1.75;1890;1.5;0;0;1890;7;398000.0
3;1.5;1630;1.5;0;0;1630;8;740000.0
3;1.0;1820;1.0;0;780;1040;7;309000.0
3;1.0;1230;1.5;0;0;1230;7;522000.0
4;2.5;3730;2.0;0;0;3730;10;840000.0
2;2.0;1680;1.0;0;0;1680;8;560000.0
2;1.5;1400;3.0;0;0;1400;7;303000.0
3;2.5;2110;2.0;0;0;2110;7;319000.0
2;1.0;1310;1.0;0;460;850;6;187300.0
2;1.75;1260;1.0;0;420;840;7;630000.0
3;1.0;1380;1.0;0;590;790;7;322000.0
4;1.5;2020;1.0;0;1010;1010;7;320000.0
3;1.5;1010;1.0;0;0;1010;7;212000.0
2;1.0;1630;1.0;0;360;1270;7;500000.0
3;1.75;2030;1.0;0;0;2030;7;440000.0
5;2.25;2890;2.0;0;0;2890;9;598000.0
5;1.5;1730;1.0;0;720;1010;7;287000.0
5;4.0;4100;2.0;0;0;4100;9;950000.0
3;2.5;2740;2.0;0;1230;1510;10;699000.0
5;3.0;2430;1.0;0;1060;1370;7;506000.0
3;1.75;1260;1.0;0;150;1110;7;194000.0
4;3.5;4130;2.0;0;0;4130;10;775000.0
3;1.0;1060;1.0;0;0;1060;7;250000.0
3;2.25;2380;1.0;0;930;1450;9;800000.0
4;2.5;2440;2.0;0;0;2440;8;576000.0
4;2.5;2160;2.0;0;0;2160;8;518000.0
4;2.75;3710;2.0;0;0;3710;9;692500.0
3;2.25;1630;1.0;0;0;1630;7;203000.0
3;2.25;1720;1.0;0;500;1220;7;550000.0
4;2.5;2382;2.0;0;0;2382;8;345000.0
5;2.5;2260;2.0;0;0;2260;8;365000.0
3;1.0;1230;1.0;0;0;1230;7;607000.0
5;3.0;3190;1.0;0;1300;1890;9;664950.0
3;1.0;1080;1.0;0;0;1080;6;210000.0
3;4.5;3850;2.0;0;730;3120;10;915000.0
3;1.75;1610;1.0;0;0;1610;8;305000.0
4;1.75;1860;1.0;0;780;1080;7;477500.0
3;1.5;1340;1.0;0;0;1340;7;417000.0
3;1.75;1630;1.0;0;0;1630;7;280000.0
3;2.5;1720;1.0;0;720;1000;8;275000.0
3;2.5;1860;2.0;0;0;1860;8;429000.0
3;1.75;1440;1.0;0;0;1440;7;410000.0
4;1.75;1880;1.0;0;940;940;7;595000.0
4;1.0;1360;1.5;0;0;1360;7;329950.0
4;3.25;2690;2.0;0;970;1720;9;635000.0
2;0.75;760;1.0;0;0;760;4;352000.0
2;2.5;2170;1.0;0;0;2170;8;740000.0
3;1.0;1150;1.0;0;0;1150;7;300000.0
2;1.0;890;1.0;0;0;890;6;199990.0
4;2.75;2240;2.0;0;700;1540;7;590000.0
3;2.5;1800;2.0;0;0;1800;8;379900.0
4;2.25;2270;1.0;0;980;1290;7;311750.0
2;1.0;1480;1.0;0;430;1050;7;410000.0
4;2.5;2910;3.0;0;0;2910;8;915000.0
2;1.0;760;1.5;0;0;760;5;92000.0
3;2.0;2460;1.0;1;0;2460;7;357000.0
3;1.75;1270;1.0;0;390;880;6;346000.0
4;3.0;3120;2.0;0;0;3120;8;790000.0
3;1.75;2370;1.0;0;1090;1280;7;385000.0
3;2.25;1220;2.0;0;0;1220;7;319000.0
3;2.5;2440;1.0;0;0;2440;9;431000.0
4;2.5;3180;1.0;0;790;2390;10;1115000.0
4;3.0;1890;1.0;0;620;1270;7;450000.0
2;1.0;860;1.0;0;0;860;6;170000.0
3;2.75;2800;1.0;0;1400;1400;7;915000.0
5;4.5;3810;2.0;0;0;3810;10;966000.0
3;2.5;1800;2.0;0;0;1800;8;485000.0
3;1.0;1010;1.0;0;0;1010;7;166000.0
2;1.0;910;1.0;0;80;830;7;445000.0
3;2.5;2080;2.0;0;0;2080;8;550000.0
1;1.0;1230;1.0;0;400;830;6;415000.0
3;2.0;1600;1.0;0;0;1600;7;460000.0
2;1.75;1870;1.0;0;910;960;7;229500.0
4;2.5;3090;2.0;0;670;2420;8;974350.0
3;2.5;1980;2.0;0;0;1980;8;470000.0
5;3.5;4410;2.0;0;0;4410;9;1095000.0
4;2.5;1820;1.0;0;600;1220;7;325000.0
4;2.25;2530;1.0;0;1210;1320;8;590000.0
3;2.25;1710;2.0;0;0;1710;7;482000.0
3;2.5;1440;2.0;0;0;1440;7;405000.0
3;2.5;1730;3.0;0;0;1730;9;625000.0
2;2.0;2280;2.0;0;0;2280;9;849900.0
5;3.5;3440;2.0;0;0;3440;9;598992.0
3;2.25;1670;3.0;0;0;1670;8;539950.0
4;2.0;1700;2.0;0;0;1700;7;277500.0
4;2.0;2040;1.0;0;1020;1020;7;749000.0
3;2.5;1450;2.0;0;0;1450;7;309000.0
4;3.0;3470;2.0;0;1100;2370;9;1218000.0
3;2.0;1390;1.0;0;0;1390;7;259000.0
2;1.0;940;1.0;0;0;940;6;265000.0
4;2.0;2320;1.5;0;700;1620;7;666570.0
3;1.0;960;1.0;0;0;960;6;158800.0
4;2.0;2070;2.0;0;0;2070;7;400000.0
3;1.75;1360;1.0;0;400;960;7;296000.0
3;3.25;2760;2.0;0;650;2110;9;375000.0
5;2.5;2760;2.0;0;0;2760;8;300000.0
3;2.25;1780;2.0;0;0;1780;7;509000.0
3;1.0;1864;1.0;0;0;1864;7;235000.0
3;4.0;2080;3.0;0;0;2080;8;715000.0
3;1.0;1100;1.0;0;0;1100;6;199990.0
4;3.25;3660;2.5;0;300;3360;10;1506000.0
3;1.75;1670;1.0;0;0;1670;8;678000.0
3;2.25;1570;1.0;0;390;1180;8;485000.0
3;1.75;1780;1.0;0;430;1350;8;399000.0
1;0.75;430;1.0;0;0;430;4;80000.0
4;2.75;2020;1.0;0;720;1300;7;366000.0
2;1.0;720;1.0;0;0;720;6;235000.0
3;1.5;1600;1.0;0;0;1600;7;220000.0
4;2.0;1950;1.0;0;790;1160;6;370000.0
3;1.0;1060;1.0;0;0;1060;6;275500.0
4;2.5;2510;1.0;0;970;1540;9;750000.0
4;1.75;1960;1.0;0;0;1960;8;260000.0
3;2.0;1790;1.5;0;0;1790;7;258000.0
4;2.5;1850;2.0;0;0;1850;8;405000.0
5;1.75;2360;1.0;0;1180;1180;7;871000.0
3;2.0;1230;1.0;0;0;1230;7;278000.0
3;1.0;1140;1.0;0;370;770;6;474000.0
5;2.0;1910;1.0;0;900;1010;7;650000.0
3;2.0;1460;2.0;0;0;1460;8;444000.0
3;2.25;2130;1.0;0;840;1290;7;360000.0
5;3.25;4130;2.0;0;0;4130;10;995000.0
2;1.0;1480;1.0;0;400;1080;7;331000.0
3;2.25;2040;2.0;0;0;2040;9;730000.0
5;2.5;1940;1.0;0;650;1290;7;299000.0
3;1.0;1230;1.5;0;0;1230;7;740000.0
4;2.75;2550;1.0;0;1110;1440;8;582800.0
3;1.5;2520;1.0;0;0;2520;8;496000.0
4;2.75;2100;1.0;0;380;1720;8;640000.0
3;1.0;1320;1.0;0;0;1320;7;150000.0
3;2.25;1800;1.0;0;600;1200;7;319000.0
3;1.75;1250;1.0;0;0;1250;7;338000.0
2;1.5;880;2.0;0;0;880;7;210000.0
4;2.5;2740;1.0;0;920;1820;8;625000.0
4;2.5;2700;2.0;0;0;2700;9;550000.0
3;1.75;1340;1.0;0;0;1340;7;260000.0
4;2.5;3350;2.0;0;0;3350;10;650000.0
3;2.75;1100;2.0;0;320;780;7;286000.0
2;1.0;620;1.0;0;0;620;6;265000.0
3;1.0;1100;1.0;0;0;1100;7;192500.0
4;3.5;3650;2.0;0;0;3650;10;824000.0
3;2.5;1730;2.0;0;0;1730;8;665000.0
3;3.5;1560;2.0;0;380;1180;8;560000.0
8;2.75;2530;2.0;0;1140;1390;7;680000.0
3;2.0;1190;1.5;0;0;1190;6;245000.0
3;2.5;1960;2.0;0;0;1960;8;560000.0
4;3.25;3440;2.0;0;0;3440;11;905000.0
3;2.0;2120;1.0;0;0;2120;9;386000.0
3;1.0;1160;1.0;0;0;1160;6;417500.0
3;2.5;1370;1.0;0;0;1370;8;394000.0
3;1.75;1420;1.0;0;420;1000;7;300000.0
4;2.25;1990;1.0;0;780;1210;8;627000.0
3;2.25;1510;1.0;0;420;1090;7;196000.0
3;2.5;1590;2.0;0;0;1590;7;454000.0
4;2.0;1790;2.0;0;0;1790;7;375000.0
5;3.25;3010;1.5;0;1000;2010;8;542500.0
4;2.5;3150;2.0;0;0;3150;9;1256500.0
4;3.0;2240;1.5;0;970;1270;8;1190000.0
4;2.75;2310;1.5;0;830;1480;8;524000.0
2;1.0;1000;1.0;0;0;1000;5;715000.0
4;1.75;2770;1.0;0;1300;1470;7;760000.0
2;1.75;1950;1.0;0;0;1950;8;255000.0
2;1.0;1010;1.0;0;0;1010;6;200000.0
3;1.0;1040;1.0;0;0;1040;7;375000.0
4;2.0;1220;2.0;0;0;1220;7;935000.0
3;2.0;1553;1.0;0;0;1553;7;240000.0
3;1.75;1830;1.0;0;630;1200;7;323000.0
4;2.5;2920;2.0;0;0;2920;10;795000.0
5;3.25;4770;1.0;0;1700;3070;11;1040000.0
3;2.25;2290;2.0;0;0;2290;8;545000.0
3;2.25;1900;1.0;0;650;1250;7;245000.0
4;2.0;1760;1.0;0;980;780;7;285000.0
3;1.0;1020;1.0;0;0;1020;7;280000.0
4;2.5;2230;2.0;0;0;2230;8;500000.0
4;2.0;2100;1.0;0;1050;1050;7;475000.0
3;1.0;1250;1.0;0;220;1030;7;155000.0
3;2.5;1670;2.0;0;0;1670;7;310000.0
3;1.0;1320;1.0;0;0;1320;7;196500.0
3;1.0;1340;1.5;0;0;1340;5;281000.0
4;1.75;2570;1.0;0;0;2570;8;762450.0
3;1.5;1850;1.0;0;0;1850;7;440250.0
4;2.75;2420;2.0;0;0;2420;8;307999.0
3;1.75;1840;1.0;0;0;1840;8;265000.0
4;1.0;1030;1.0;0;0;1030;6;205000.0
2;3.25;1840;3.0;0;0;1840;8;601450.0
3;2.5;2540;2.0;0;0;2540;9;425000.0
3;2.5;1560;1.0;0;350;1210;7;324950.0
4;2.5;2380;2.0;0;0;2380;7;332000.0
4;2.5;2810;1.0;0;1100;1710;8;825000.0
4;1.75;2260;1.0;0;1040;1220;8;864000.0
4;1.75;1680;1.0;0;0;1680;8;540400.0
2;1.0;1150;1.0;1;0;1150;6;825000.0
4;1.75;1800;1.0;0;900;900;6;377000.0
4;2.75;4140;2.0;0;0;4140;11;657500.0
4;2.25;2090;1.0;0;420;1670;9;274000.0
4;3.5;3500;2.0;0;650;2850;9;998000.0
3;1.75;1670;1.0;0;500;1170;7;239950.0
4;1.5;1800;1.0;0;0;1800;7;271000.0
3;2.5;2690;2.0;0;0;2690;8;445000.0
2;1.0;910;1.0;0;0;910;5;244500.0
3;1.0;960;1.0;0;0;960;7;255000.0
5;3.5;3600;2.0;0;920;2680;10;817500.0
4;3.0;4260;2.0;0;0;4260;11;1000000.0
3;2.25;1420;2.0;0;480;940;8;425000.0
3;1.0;1010;1.0;0;0;1010;6;189000.0
4;2.25;2370;1.0;0;710;1660;8;670000.0
3;2.5;2240;2.0;0;0;2240;8;319950.0
3;2.0;2230;1.5;0;940;1290;7;736500.0
3;1.0;860;1.0;0;0;860;6;219900.0
3;2.0;1410;1.0;0;0;1410;7;220000.0
3;1.5;1510;1.0;0;0;1510;6;199950.0
3;2.25;1500;1.0;0;290;1210;7;290000.0
2;1.0;820;1.0;0;0;820;6;295000.0
4;2.5;2880;2.0;0;0;2880;9;440000.0
2;1.0;820;1.0;0;0;820;5;102500.0
4;2.5;3190;1.0;0;980;2210;8;659000.0
4;2.5;2540;2.0;0;0;2540;9;630000.0
3;1.0;1350;1.5;0;0;1350;6;160000.0
3;1.0;940;1.0;0;0;940;7;354000.0
4;2.5;3420;2.0;0;0;3420;9;570000.0
4;2.5;3110;2.0;0;0;3110;9;655000.0
2;1.75;1810;2.0;0;0;1810;8;489000.0
3;1.0;1120;1.0;0;0;1120;6;225000.0
4;2.0;1800;1.0;0;900;900;7;439000.0
4;1.75;2251;1.0;0;861;1390;8;305000.0
3;1.0;1410;1.0;0;0;1410;7;299950.0
3;2.5;1350;2.0;0;0;1350;7;613000.0
3;2.5;2290;2.0;0;0;2290;8;622500.0
3;2.25;1780;1.5;0;390;1390;9;771000.0
3;1.0;1560;1.0;0;0;1560;7;273000.0
3;2.25;2160;2.0;0;580;1580;7;430000.0
3;2.25;2190;1.0;0;860;1330;7;530000.0
4;2.5;2640;2.0;0;0;2640;8;429900.0
4;3.5;3660;2.0;0;1000;2660;10;475000.0
3;1.75;1580;1.0;0;0;1580;7;225000.0
3;2.5;1530;1.0;0;260;1270;7;332000.0
4;2.5;2090;2.0;0;0;2090;8;601000.0
5;1.0;1950;1.5;0;500;1450;7;438000.0
1;1.0;740;1.0;0;0;740;7;299000.0
2;1.0;1060;1.0;0;240;820;7;170500.0
3;2.0;1560;1.0;0;0;1560;6;196440.0
3;1.0;990;1.5;0;0;990;7;173250.0
3;1.0;1330;1.0;0;0;1330;7;535000.0
4;3.5;3510;2.0;0;0;3510;10;729950.0
3;2.25;1570;1.0;0;390;1180;7;274950.0
3;2.5;2790;2.0;0;0;2790;8;650000.0
3;2.0;2090;1.5;0;0;2090;7;785000.0
5;1.5;1840;1.5;0;0;1840;7;285000.0
3;2.5;2320;1.0;0;530;1790;9;568000.0
3;1.0;1180;1.0;0;0;1180;7;190000.0
3;1.0;1460;1.0;0;0;1460;6;222000.0
3;1.75;1480;1.0;0;0;1480;7;465000.0
4;1.75;1730;1.0;0;850;880;7;465000.0
4;2.5;2470;2.0;0;0;2470;8;449950.0
6;4.5;3390;2.0;0;950;2440;8;303500.0
4;1.0;1330;1.5;0;0;1330;6;249950.0
2;1.5;2210;1.0;0;680;1530;8;850000.0
2;1.5;1170;1.0;0;0;1170;6;335000.0
3;2.25;1640;1.0;0;0;1640;8;352000.0
5;2.75;2860;2.5;0;480;2380;8;750000.0
3;2.75;2030;1.0;0;820;1210;7;360000.0
4;2.25;2580;2.0;0;0;2580;9;673000.0
4;3.5;3510;2.0;0;910;2600;9;1007500.0
3;1.5;1240;1.0;0;0;1240;6;214000.0
3;2.5;2710;1.0;0;630;2080;9;999000.0
3;2.25;1530;2.0;0;480;1050;9;465000.0
4;3.5;4360;2.0;0;0;4360;12;1450000.0
3;1.5;2160;1.0;0;760;1400;8;650000.0
3;2.25;2340;1.0;0;1130;1210;7;510000.0
3;2.5;1690;2.0;0;280;1410;8;336900.0
3;1.75;1010;1.0;0;0;1010;7;230000.0
3;2.0;1380;2.0;0;0;1380;7;265000.0
3;1.75;1560;1.0;0;0;1560;7;590000.0
3;2.5;1750;2.0;0;0;1750;7;595000.0
4;2.5;2650;2.0;0;0;2650;8;790000.0
3;1.75;2010;1.0;0;780;1230;7;700000.0
4;2.75;2400;1.0;0;1080;1320;7;392500.0
4;2.5;1780;2.0;0;0;1780;7;175000.0
3;1.75;2410;1.0;0;1000;1410;8;432000.0
3;1.75;1330;1.0;0;0;1330;7;525000.0
3;2.0;1790;1.0;0;400;1390;7;317000.0
3;1.0;1030;1.0;0;0;1030;7;240000.0
2;2.25;2210;1.0;0;800;1410;8;614306.0
4;2.75;2720;1.0;0;1070;1650;8;469950.0
4;2.0;1480;1.0;0;0;1480;7;260000.0
3;2.75;2290;1.0;0;890;1400;7;481000.0
4;1.5;3390;2.0;0;860;2530;8;895000.0
3;2.5;1810;3.0;0;0;1810;8;449000.0
2;1.0;1250;1.0;0;0;1250;7;365000.0
4;2.5;2495;2.0;0;0;2495;7;436000.0
3;4.0;4380;2.0;0;0;4380;11;1050000.0
3;2.5;2070;2.0;0;0;2070;8;567000.0
3;1.5;1670;1.0;0;300;1370;7;280500.0
3;2.25;1280;3.0;0;0;1280;8;355000.0
5;2.75;3160;2.0;0;1420;1740;10;540000.0
3;1.5;1820;1.0;0;0;1820;7;264000.0
2;1.5;1300;2.0;0;140;1160;8;482000.0
5;2.5;2840;1.0;0;1370;1470;8;375000.0
5;4.0;4690;2.0;0;1650;3040;9;2048000.0
3;2.5;2550;2.0;0;0;2550;10;1400000.0
3;1.0;1010;1.0;0;0;1010;7;149500.0
3;2.5;1450;2.0;0;0;1450;7;359000.0
4;3.75;4260;2.0;0;0;4260;10;1065000.0
3;3.25;1490;3.0;0;270;1220;8;580000.0
4;1.5;1840;2.0;0;0;1840;7;262000.0
6;3.75;2740;1.0;0;1100;1640;7;585444.0
4;1.0;1640;1.5;0;180;1460;7;325000.0
5;2.5;2340;2.0;1;0;2340;8;949950.0
3;2.25;1360;2.0;0;266;1094;8;399950.0
5;2.5;3780;1.0;0;1890;1890;9;725000.0
4;2.5;2110;1.0;0;820;1290;8;460000.0
2;2.0;1170;1.0;0;0;1170;7;393820.0
4;2.75;2610;1.0;0;850;1760;8;762500.0
3;2.0;1840;1.0;0;830;1010;7;730001.0
4;2.75;4030;2.0;0;720;3310;8;835000.0
3;2.5;3800;2.0;0;590;3210;8;472000.0
4;2.5;2496;2.0;0;0;2496;9;661000.0
3;2.5;2690;3.0;0;0;2690;10;979000.0
3;1.75;1390;1.0;0;0;1390;7;218500.0
3;2.5;1650;3.0;0;0;1650;8;370000.0
6;3.5;2580;1.0;0;1290;1290;8;604000.0
3;1.75;1590;3.0;0;0;1590;8;609500.0
4;2.5;3700;2.0;0;0;3700;9;650000.0
4;2.75;1660;1.5;0;380;1280;7;685000.0
3;1.75;1560;1.0;0;310;1250;7;440000.0
4;3.5;2584;2.0;0;0;2584;8;429900.0
3;2.5;1430;3.0;0;0;1430;8;443600.0
2;1.0;670;1.0;0;0;670;6;183000.0
4;3.5;4190;2.0;0;0;4190;11;1160000.0
5;3.25;4500;2.0;0;1500;3000;8;860000.0
3;1.0;1330;1.5;0;0;1330;6;389000.0
4;1.0;1290;1.5;0;0;1290;7;275500.0
4;2.5;3350;2.0;0;710;2640;9;925000.0
2;1.0;1080;1.0;0;0;1080;7;345000.0
2;1.5;1160;2.0;0;0;1160;7;229950.0
4;2.25;1677;2.0;0;0;1677;7;281000.0
3;2.5;1730;2.0;0;0;1730;7;250000.0
4;2.0;2030;2.0;0;400;1630;7;435000.0
3;1.75;1280;1.5;0;0;1280;7;242000.0
3;2.5;1940;1.0;0;970;970;7;576000.0
3;2.25;1610;2.0;0;0;1610;8;450000.0
2;1.0;900;1.0;0;0;900;7;375000.0
3;3.0;2640;2.0;0;0;2640;9;535000.0
3;1.75;2120;1.0;0;400;1720;9;892500.0
2;1.0;1790;1.0;0;750;1040;7;710000.0
3;1.75;1610;1.0;0;510;1100;7;225000.0
4;2.5;2280;2.0;0;0;2280;8;520000.0
3;2.5;1690;2.0;0;0;1690;7;297000.0
4;2.5;2350;2.0;0;0;2350;8;440000.0
2;1.0;1030;1.0;0;0;1030;7;460000.0
3;1.75;1790;1.5;0;0;1790;7;320000.0
3;2.25;1640;1.0;0;0;1640;8;515000.0
3;1.5;1430;1.0;0;610;820;7;198000.0
3;2.25;2770;2.0;0;0;2770;10;675000.0
3;1.0;960;1.0;0;0;960;6;218000.0
3;1.5;1490;1.0;0;480;1010;7;256400.0
3;2.25;1620;2.0;0;0;1620;7;280500.0
3;1.0;980;1.5;0;0;980;7;340000.0
2;1.0;1420;1.0;0;600;820;7;550000.0
3;1.0;1910;1.0;0;640;1270;8;588000.0
4;1.75;2160;2.0;0;0;2160;8;475000.0
4;2.0;2360;1.0;0;1100;1260;7;730000.0
3;2.0;1300;1.5;0;0;1300;7;287000.0
4;1.75;2010;1.0;0;710;1300;7;650000.0
3;2.5;2930;2.0;0;0;2930;8;754842.0
4;2.5;2700;2.0;0;0;2700;9;1557600.0
3;2.5;2500;2.0;0;0;2500;10;705000.0
4;3.0;4480;2.0;0;0;4480;9;835000.0
4;2.5;2810;2.0;0;0;2810;9;518380.0
4;2.5;2750;2.0;0;0;2750;10;730000.0
4;3.0;2390;2.0;0;0;2390;7;269950.0
3;2.0;1640;1.0;0;0;1640;8;349950.0
2;1.0;1070;1.0;0;0;1070;7;324000.0
3;1.75;1650;1.0;0;0;1650;8;275000.0
4;2.5;2100;1.0;0;860;1240;7;630000.0
3;1.75;1570;1.0;0;650;920;7;550000.0
4;1.0;1170;1.5;0;0;1170;6;350000.0
3;3.25;1540;3.0;0;0;1540;9;690000.0
4;2.5;2600;2.0;0;0;2600;10;402500.0
3;1.75;1880;1.0;0;0;1880;7;334950.0
3;2.5;1300;3.0;0;0;1300;8;610000.0
4;2.75;4430;2.0;0;0;4430;10;970000.0
3;2.0;1250;3.0;0;0;1250;7;418000.0
2;1.5;1076;3.0;0;0;1076;7;290000.0
4;2.5;2720;2.0;0;0;2720;9;368000.0
3;1.75;2530;1.0;0;730;1800;7;375000.0
2;1.0;1240;1.0;0;0;1240;7;215000.0
3;2.5;1530;2.0;0;0;1530;7;452000.0
3;2.5;2440;2.0;0;460;1980;9;679900.0
3;2.0;1510;1.0;0;0;1510;6;332000.0
4;2.75;3630;2.0;0;0;3630;10;962800.0
4;3.0;3150;2.0;0;0;3150;9;700000.0
3;2.0;2390;2.0;0;0;2390;8;1100000.0
2;1.0;840;1.0;0;0;840;6;251000.0
3;1.0;1550;1.5;0;0;1550;7;525000.0
4;1.75;2580;1.0;0;1290;1290;8;383000.0
5;1.5;3360;2.0;0;0;3360;9;834995.0
4;1.75;1480;1.0;0;0;1480;7;310000.0
4;2.5;2830;2.0;0;0;2830;9;1035290.0
3;1.0;1390;1.0;0;0;1390;7;745000.0
5;2.0;1760;1.0;0;200;1560;8;647500.0
4;2.0;980;1.0;0;0;980;7;295000.0
3;2.0;1380;1.0;0;0;1380;7;640000.0
3;1.75;1340;1.0;0;0;1340;7;330000.0
3;1.75;2380;1.0;0;1000;1380;6;227000.0
4;2.25;2050;2.0;0;0;2050;8;500000.0
3;2.25;1880;2.0;0;0;1880;8;550000.0
4;4.0;1550;1.5;0;0;1550;7;707500.0
5;1.0;1670;1.5;0;0;1670;8;1300000.0
5;2.5;2880;1.0;0;1200;1680;8;360000.0
3;2.25;1740;1.0;0;500;1240;8;435000.0
3;2.0;1700;1.0;0;730;970;6;225000.0
4;2.75;2610;2.0;0;0;2610;8;372000.0
3;2.25;1800;1.0;0;500;1300;7;365000.0
2;1.75;1460;1.0;0;0;1460;7;237950.0
4;2.0;2970;2.5;0;0;2970;9;1260000.0
3;2.0;1760;1.0;0;600;1160;7;715000.0
5;1.75;1920;1.0;0;660;1260;7;715000.0
10;5.25;4590;1.0;0;2090;2500;9;1148000.0
3;2.5;1070;2.0;0;350;720;7;370000.0
4;1.5;1860;1.0;0;780;1080;7;450000.0
2;1.0;940;1.0;0;0;940;7;350000.0
1;1.5;1010;1.0;0;0;1010;7;410000.0
2;1.0;1410;1.5;0;0;1410;6;260000.0
3;1.75;1960;1.0;0;980;980;7;320000.0
4;2.5;2660;2.0;0;0;2660;9;755000.0
5;2.0;2110;1.0;0;1000;1110;7;280000.0
4;2.5;2660;2.0;0;0;2660;9;590000.0
3;1.5;2600;1.0;0;1200;1400;7;540000.0
4;2.5;3050;1.0;0;1500;1550;8;465000.0
3;1.75;1660;1.0;0;280;1380;8;420000.0
3;1.5;1600;1.5;0;350;1250;8;625000.0
4;1.5;2430;2.5;0;0;2430;8;940000.0
3;2.5;2150;2.0;0;0;2150;8;378000.0
3;1.5;1030;1.0;0;0;1030;6;345000.0
5;4.5;5160;2.0;0;0;5160;12;1900000.0
3;2.0;2350;1.0;0;750;1600;7;430000.0
4;2.25;3300;1.5;0;480;2820;8;1250000.0
5;3.5;4320;2.0;0;0;4320;11;1670000.0
2;1.75;1030;2.0;0;265;765;7;335000.0
4;2.25;1890;1.0;0;630;1260;8;291000.0
4;2.75;5440;1.0;0;2720;2720;9;850000.0
3;2.5;3160;1.0;0;1000;2160;11;1150000.0
4;1.5;1300;1.0;0;0;1300;7;259500.0
3;1.0;1140;1.0;0;0;1140;7;234300.0
4;2.75;2790;2.0;0;0;2790;8;505657.0
2;2.25;1040;2.0;0;0;1040;8;450000.0
3;1.0;1220;1.0;0;0;1220;7;875000.0
2;1.0;1430;1.0;0;320;1110;7;380950.0
3;1.5;2390;1.0;0;0;2390;7;400000.0
3;1.75;2180;1.0;0;1090;1090;8;472000.0
3;1.75;2230;1.0;0;600;1630;8;340000.0
5;2.75;3050;2.0;0;0;3050;8;740000.0
4;1.5;1380;1.0;0;300;1080;7;477000.0
4;3.5;4140;2.0;0;980;3160;10;850000.0
4;2.75;3370;1.0;0;1450;1920;8;813000.0
2;1.0;670;1.0;0;0;670;6;250000.0
2;1.0;700;1.0;0;0;700;6;395000.0
3;2.5;1740;3.0;0;0;1740;8;580000.0
4;1.5;1470;1.0;0;0;1470;7;325000.0
3;1.0;930;1.5;0;0;930;5;176500.0
4;2.25;1990;1.0;0;810;1180;8;280000.0
6;2.0;2780;2.5;0;0;2780;7;325000.0
3;1.5;1010;2.0;0;0;1010;8;356999.0
3;1.0;1050;1.0;0;0;1050;7;325000.0
3;2.0;2120;2.0;0;0;2120;7;535000.0
3;3.5;2490;2.0;0;470;2020;8;616950.0
3;1.0;1200;1.0;0;250;950;7;476500.0
4;2.25;2350;1.0;0;840;1510;7;800000.0
4;5.0;5810;2.0;0;2020;3790;10;1875000.0
2;1.75;1090;1.0;0;0;1090;8;265000.0
3;2.0;1750;1.0;0;340;1410;8;420000.0
2;1.0;930;1.0;0;0;930;5;105500.0
4;1.5;2150;1.0;0;0;2150;7;400000.0
4;2.75;1950;1.0;0;700;1250;7;621000.0
2;2.0;1510;1.0;0;260;1250;6;172500.0
4;2.25;2820;1.0;0;900;1920;8;321027.0
3;2.5;2130;3.0;0;0;2130;9;1065000.0
4;2.5;2430;2.0;0;0;2430;8;321000.0
2;1.75;1280;1.0;0;280;1000;7;585000.0
4;3.5;4083;2.0;0;0;4083;10;637000.0
5;3.0;2450;2.0;0;0;2450;7;525000.0
4;1.0;1530;1.5;0;130;1400;7;245000.0
4;2.75;4190;1.0;0;2150;2040;9;910000.0
4;2.75;2580;2.0;0;800;1780;8;1075000.0
4;2.75;3270;2.0;0;0;3270;9;939000.0
2;1.5;1940;1.0;0;970;970;7;535000.0
3;2.5;1880;1.0;0;620;1260;7;565000.0
4;2.25;2080;1.0;0;620;1460;8;440000.0
3;1.75;920;1.0;0;100;820;6;589000.0
4;2.25;2510;2.0;0;0;2510;8;788500.0
3;1.0;1250;1.0;0;0;1250;7;463000.0
2;1.0;1010;1.0;0;0;1010;6;300000.0
4;2.5;1920;2.0;0;0;1920;7;329950.0
6;5.0;3440;2.0;0;160;3280;8;495000.0
2;1.0;780;1.0;0;0;780;6;285000.0
2;2.25;1470;2.0;0;130;1340;8;510000.0
2;1.0;1050;1.0;0;200;850;7;430000.0
5;2.0;2140;1.5;0;120;2020;7;680000.0
2;2.75;1770;1.0;0;560;1210;8;279000.0
4;2.5;3700;1.0;0;1080;2620;11;1250000.0
5;2.0;3920;1.5;0;1360;2560;7;760000.0
3;1.5;1270;1.0;0;0;1270;7;246500.0
6;3.5;2400;2.0;0;760;1640;8;435000.0
3;1.75;1930;1.5;0;0;1930;6;285000.0
3;1.0;950;1.0;0;0;950;7;395000.0
3;1.75;2330;1.0;0;940;1390;7;535000.0
3;3.5;3380;2.0;0;680;2700;9;554000.0
5;2.5;2540;2.0;0;780;1760;8;620000.0
4;2.75;3070;2.0;0;0;3070;9;535000.0
4;3.25;2820;1.0;0;1410;1410;7;485000.0
2;1.5;1010;1.0;0;0;1010;7;395000.0
4;2.5;2590;2.0;0;0;2590;8;533000.0
2;2.0;1700;1.0;0;850;850;5;189000.0
3;2.25;1260;2.0;0;0;1260;7;477000.0
3;1.75;2920;1.0;0;0;2920;7;325000.0
3;1.5;1300;1.0;0;0;1300;7;235000.0
3;1.0;1450;1.5;0;0;1450;7;450000.0
3;1.5;1320;1.0;0;0;1320;7;412000.0
4;2.5;2480;1.0;0;970;1510;7;560000.0
3;2.5;2690;2.0;0;850;1840;7;925000.0
4;3.0;3580;1.5;0;0;3580;10;925000.0
3;1.75;1560;1.0;0;790;770;6;481000.0
3;3.25;1430;2.0;0;270;1160;8;478000.0
3;1.0;1000;1.0;0;0;1000;7;396480.0
5;2.0;1750;1.0;0;0;1750;7;340000.0
4;3.0;2840;1.5;0;780;2060;8;735000.0
4;3.25;3276;2.0;0;0;3276;9;720000.0
2;1.5;1450;1.0;0;500;950;7;557000.0
4;2.0;1520;1.0;0;0;1520;7;425000.0
3;1.5;1180;1.0;0;0;1180;7;193000.0
5;1.5;1700;1.5;0;0;1700;7;548000.0
3;2.5;2980;1.0;0;1050;1930;8;615000.0
3;2.5;2280;2.0;0;400;1880;8;535000.0
2;1.0;1470;1.0;0;0;1470;7;400000.0
3;1.75;1070;1.0;0;0;1070;7;224400.0
3;1.0;940;1.0;0;0;940;7;342500.0
3;1.75;1290;1.0;0;0;1290;7;370000.0
3;1.0;1480;1.5;0;0;1480;7;397500.0
5;1.75;1960;1.0;0;0;1960;7;434400.0
4;1.75;2440;1.0;0;830;1610;8;330000.0
4;1.5;1690;1.0;0;0;1690;5;235000.0
2;1.0;1420;1.0;0;240;1180;7;360000.0
5;1.75;3000;1.0;0;1500;1500;7;380000.0
3;3.5;4070;2.0;0;0;4070;11;1480000.0
4;2.5;2340;1.0;0;0;2340;8;880000.0
3;2.5;3120;2.0;0;1180;1940;9;850000.0
3;1.75;3440;1.5;0;0;3440;8;430000.0
2;2.0;1350;1.0;0;0;1350;8;480000.0
2;1.0;700;1.0;0;0;700;7;282150.0
5;4.75;6240;1.0;0;1630;4610;11;2950000.0
2;2.0;1370;2.0;0;220;1150;8;448175.0
4;1.0;1350;1.0;0;0;1350;7;200000.0
4;2.5;3130;2.0;0;0;3130;7;320000.0
3;2.5;2550;2.0;0;0;2550;8;595000.0
5;2.75;2740;1.0;0;1370;1370;8;541125.0
5;2.5;2510;1.0;0;1020;1490;7;475000.0
3;2.5;2410;1.0;0;810;1600;9;490000.0
4;2.75;3170;2.0;0;0;3170;10;750000.0
2;1.0;820;1.0;0;0;820;7;554000.0
3;1.75;1410;1.0;0;0;1410;7;334200.0
2;2.25;1260;3.0;0;0;1260;8;530000.0
2;1.0;1088;1.0;0;0;1088;6;238000.0
3;2.25;1250;3.0;0;0;1250;8;205000.0
4;2.5;2540;2.0;0;0;2540;9;365000.0
4;3.0;2160;1.0;0;840;1320;7;228950.0
2;1.0;1000;1.0;0;0;1000;7;305000.0
4;1.75;1840;1.0;0;0;1840;5;327000.0
2;1.0;810;1.0;0;0;810;7;155000.0
3;2.25;1280;2.0;0;200;1080;8;490000.0
3;1.75;1420;1.0;0;0;1420;7;192500.0
4;3.5;4270;1.0;0;0;4270;12;1100000.0
4;1.0;1150;1.5;0;0;1150;7;485000.0
6;2.5;1880;1.0;0;240;1640;7;520500.0
4;2.5;2100;1.0;0;0;2100;8;352500.0
4;2.75;2880;1.5;0;1170;1710;9;920000.0
3;2.25;1640;1.0;0;420;1220;7;190000.0
3;1.5;1290;1.0;0;270;1020;7;240000.0
3;2.5;2480;2.0;0;0;2480;8;475000.0
2;1.0;840;1.0;0;0;840;6;405100.0
2;2.75;1590;1.5;0;0;1590;5;199950.0
3;1.0;910;1.0;0;0;910;7;305000.0
4;2.5;3550;2.0;0;0;3550;9;625000.0
3;1.0;1300;1.0;0;0;1300;7;236000.0
1;1.0;1080;1.0;0;0;1080;6;112000.0
3;2.0;1400;1.0;0;560;840;7;373000.0
3;2.5;1230;1.0;0;0;1230;7;425000.0
3;1.75;1260;1.0;0;0;1260;7;335000.0
2;1.0;1030;1.0;0;0;1030;6;455000.0
4;2.75;2700;2.0;0;0;2700;9;385000.0
2;1.0;1760;1.0;0;760;1000;7;490000.0
3;1.0;940;1.5;0;0;940;7;520000.0
4;2.25;2090;2.0;0;0;2090;8;600000.0
4;2.5;3070;1.0;0;1000;2070;9;1920000.0
3;2.25;2120;1.0;0;0;2120;8;530000.0
2;1.0;970;1.0;0;0;970;7;515000.0
4;2.5;1320;1.0;0;0;1320;7;455000.0
4;2.75;1820;1.0;0;600;1220;7;430000.0
4;3.25;4250;2.0;0;900;3350;10;2196000.0
3;1.0;900;1.5;0;0;900;7;400000.0
4;3.5;2660;2.0;0;740;1920;8;549995.0
4;2.5;2660;1.0;0;0;2660;7;772650.0
3;2.25;3000;1.5;1;0;3000;11;2400000.0
3;2.5;3020;2.0;0;0;3020;8;515000.0
3;1.5;1710;1.0;0;530;1180;7;690000.0
2;1.0;720;1.0;0;0;720;6;350000.0
4;2.5;1770;2.0;0;0;1770;7;353500.0
4;4.5;5670;2.0;0;0;5670;11;935000.0
3;2.0;2000;1.0;0;900;1100;7;677000.0
3;2.5;2150;2.0;0;0;2150;8;410000.0
3;2.25;1646;2.0;0;0;1646;7;305000.0
4;2.25;2390;2.0;0;0;2390;8;350000.0
3;1.0;1320;1.0;0;0;1320;7;425000.0
5;2.25;2660;1.5;0;0;2660;7;305000.0
4;2.5;2660;2.0;0;0;2660;8;447000.0
3;2.5;2450;2.0;0;650;1800;9;952000.0
4;2.5;2660;2.0;0;0;2660;8;423000.0
3;1.0;1340;1.5;0;0;1340;7;255000.0
4;1.75;1830;1.0;0;820;1010;7;433000.0
3;2.5;1420;2.0;0;110;1310;8;290000.0
4;2.5;2710;2.0;0;0;2710;9;600000.0
4;2.5;2490;2.0;0;0;2490;8;595500.0
3;1.75;1980;1.0;0;800;1180;8;268000.0
3;2.5;2490;2.0;0;0;2490;8;504750.0
3;1.75;2150;2.0;0;750;1400;8;762000.0
3;1.75;1600;1.0;0;0;1600;7;285000.0
4;1.75;2180;1.5;0;160;2020;8;625000.0
2;1.0;1050;1.0;0;0;1050;7;630000.0
3;3.0;1320;3.0;0;0;1320;8;510000.0
4;3.5;3110;2.0;0;0;3110;8;600600.0
3;1.0;1210;1.0;0;0;1210;7;457500.0
4;1.5;2230;1.0;0;1010;1220;7;355000.0
3;1.5;2320;1.0;0;0;2320;7;307000.0
3;2.25;1190;3.0;0;0;1190;8;350000.0
4;1.75;2230;1.0;0;910;1320;7;560000.0
3;3.0;4040;2.0;0;1010;3030;10;950000.0
4;2.5;2280;2.0;0;0;2280;8;626100.0
3;3.5;2600;2.0;0;0;2600;8;985000.0
5;2.75;3890;2.0;0;0;3890;9;772500.0
3;2.5;1980;2.0;0;0;1980;8;220000.0
5;2.0;1600;1.5;0;0;1600;7;365000.0
3;1.75;1960;1.0;0;560;1400;7;425000.0
3;1.0;1290;1.0;0;0;1290;7;658000.0
4;2.25;2420;1.0;0;1070;1350;8;549000.0
3;1.75;1340;1.0;0;0;1340;7;239000.0
3;2.0;2100;1.0;0;0;2100;8;399000.0
6;3.0;2980;1.5;0;0;2980;8;1313000.0
5;2.5;2730;1.0;0;1070;1660;7;545000.0
4;4.0;5040;1.0;0;2170;2870;10;2850000.0
3;1.0;1060;1.0;0;0;1060;7;400000.0
4;2.0;1800;1.5;0;0;1800;7;632750.0
5;1.5;2680;1.0;0;1230;1450;8;898000.0
3;2.5;2180;2.0;0;0;2180;8;560000.0
3;2.25;2030;1.0;0;670;1360;8;287500.0
3;2.25;1470;1.0;0;310;1160;7;220000.0
2;1.0;2160;1.0;0;800;1360;7;305000.0
3;1.5;1390;1.0;0;0;1390;7;450000.0
2;1.75;2040;1.5;1;0;2040;7;615000.0
3;1.75;1260;1.0;0;0;1260;7;259000.0
4;2.5;3100;2.0;0;0;3100;9;967000.0
3;1.5;1510;1.0;0;0;1510;7;327000.0
2;1.75;2056;1.0;0;1008;1048;7;289000.0
5;1.0;2550;2.5;0;0;2550;9;847000.0
4;3.0;1986;2.0;0;240;1746;8;715000.0
3;1.75;1530;1.0;0;0;1530;7;269000.0
2;1.0;960;1.0;0;150;810;6;232000.0
3;2.25;1980;1.0;0;0;1980;8;550000.0
3;3.25;2080;2.0;0;860;1220;8;969500.0
4;1.0;1550;1.0;0;0;1550;6;351000.0
3;2.5;1880;2.0;0;0;1880;8;325000.0
3;3.5;2440;2.0;0;470;1970;7;730000.0
4;1.75;2500;1.0;0;1250;1250;7;387000.0
3;2.5;1690;2.0;0;0;1690;7;452000.0
5;2.5;2380;1.0;0;840;1540;8;600000.0
3;2.5;1470;2.0;0;0;1470;7;339900.0
4;1.75;2790;1.0;0;1340;1450;7;568000.0
4;2.5;3010;2.0;0;0;3010;8;695000.0
3;2.5;1810;2.0;0;460;1350;7;487500.0
5;2.5;2840;1.0;0;1220;1620;7;739000.0
6;5.25;2860;2.0;0;0;2860;7;300000.0
3;2.0;1810;1.0;0;0;1810;7;290000.0
4;2.0;1710;1.0;0;680;1030;7;295000.0
3;1.75;2080;1.0;0;1000;1080;7;329950.0
3;1.0;1100;1.0;0;140;960;6;157500.0
4;2.5;2960;2.0;0;0;2960;9;426500.0
3;2.25;1410;3.0;0;0;1410;8;406100.0
4;2.5;3110;2.0;0;0;3110;10;960000.0
3;2.5;2880;1.0;0;1360;1520;8;1989000.0
2;2.25;1730;2.0;1;0;1730;7;800000.0
3;2.0;1470;1.0;0;0;1470;6;250000.0
5;2.75;2720;1.0;0;1020;1700;7;456000.0
3;2.0;1560;1.0;0;300;1260;7;260750.0
4;2.5;2770;2.0;0;0;2770;9;641000.0
2;1.0;930;1.0;0;0;930;6;200000.0
4;2.5;2720;1.0;0;600;2120;8;348000.0
4;2.25;2860;2.0;0;0;2860;10;872000.0
3;2.5;2720;2.0;0;0;2720;8;420000.0
3;2.0;1680;1.0;0;0;1680;7;370000.0
4;2.25;2440;2.0;0;0;2440;8;330000.0
3;1.0;1010;1.0;0;0;1010;7;201700.0
3;1.0;1200;1.0;0;0;1200;7;219950.0
3;1.75;2210;1.0;0;820;1390;8;625000.0
4;2.0;2330;1.0;0;1100;1230;7;500000.0
3;1.0;1120;1.0;0;0;1120;7;360000.0
3;1.75;1660;1.0;0;620;1040;7;288000.0
3;1.0;1290;1.0;0;500;790;6;450000.0
4;2.0;1910;1.0;0;0;1910;7;335000.0
3;1.5;1750;1.0;0;700;1050;7;716528.0
3;3.0;2340;2.0;0;180;2160;8;660000.0
4;3.75;3610;3.0;0;320;3290;11;830005.0
3;1.75;1560;1.5;0;560;1000;7;451000.0
4;2.5;2790;2.0;0;0;2790;9;685100.0
4;2.5;2575;2.0;0;0;2575;8;359000.0
3;1.75;2910;1.0;0;1380;1530;7;570000.0
5;5.0;5450;2.0;0;0;5450;11;3418800.0
3;3.25;3230;2.0;0;0;3230;10;1776000.0
5;3.5;2920;2.0;0;660;2260;9;1065000.0
8;4.0;7710;3.5;0;1620;6090;12;3300000.0
2;1.0;1270;1.0;0;0;1270;7;425000.0
6;2.25;2930;1.0;0;1200;1730;8;429300.0
5;3.0;3610;2.0;0;0;3610;8;549900.0
3;1.5;1370;1.0;0;0;1370;7;246900.0
3;3.25;3530;2.0;0;870;2660;9;1550000.0
4;3.25;3300;2.0;0;0;3300;10;1350000.0
2;2.0;1370;1.0;0;0;1370;8;380000.0
3;1.75;1540;2.0;0;0;1540;6;273000.0
4;1.5;1430;1.0;0;400;1030;7;215000.0
3;2.25;1560;1.0;0;300;1260;7;399950.0
3;2.5;1990;2.0;0;0;1990;8;334500.0
4;2.75;2520;2.0;0;800;1720;8;508500.0
3;1.0;3180;1.0;0;1780;1400;8;340000.0
3;2.5;2430;2.0;0;0;2430;8;362300.0
3;2.0;1330;1.0;0;0;1330;7;205500.0
4;3.5;3820;2.0;0;1380;2440;8;550000.0
3;3.25;1876;3.0;0;0;1876;9;613500.0
5;2.25;2460;1.0;0;1130;1330;8;599000.0
3;2.5;2340;1.0;0;0;2340;9;525000.0
3;1.75;1910;1.0;0;830;1080;7;700000.0
4;2.5;2470;2.0;0;0;2470;8;470000.0
3;2.25;1510;1.0;0;360;1150;7;269950.0
2;1.0;1170;1.0;0;0;1170;6;175000.0
3;1.5;1580;1.0;0;0;1580;7;296500.0
5;3.25;4230;2.0;0;1510;2720;10;875000.0
2;1.0;1300;1.0;0;0;1300;6;175000.0
3;1.75;1740;1.0;0;600;1140;7;255000.0
4;2.5;3250;2.0;0;0;3250;8;353500.0
4;3.5;3760;2.0;0;900;2860;9;919204.0
2;1.75;2080;1.0;0;1000;1080;7;740000.0
4;2.5;1620;2.0;0;0;1620;7;305000.0
2;1.5;1190;3.0;0;0;1190;8;300500.0
4;3.0;3220;1.5;0;0;3220;9;584950.0
2;1.0;920;1.0;0;0;920;5;255000.0
3;2.0;1320;1.0;0;300;1020;6;462600.0
4;2.5;1870;2.0;0;0;1870;7;272000.0
4;1.75;2040;1.0;0;600;1440;8;540000.0
3;2.25;1470;1.0;0;310;1160;7;269000.0
2;1.0;790;1.0;0;0;790;6;436000.0
3;2.25;2340;1.0;0;1000;1340;8;438000.0
3;2.5;1760;2.0;0;0;1760;8;281000.0
2;1.0;690;1.0;0;0;690;6;338000.0
3;2.5;2770;2.0;0;0;2770;9;749950.0
3;3.5;1500;3.0;0;0;1500;7;337900.0
3;2.5;1700;2.0;0;0;1700;7;319950.0
3;2.25;1610;1.0;0;500;1110;7;277000.0
3;2.0;1340;1.5;0;0;1340;7;339950.0
1;1.0;690;1.0;0;0;690;6;280000.0
3;2.5;1650;2.0;0;0;1650;8;465000.0
4;2.5;3284;2.0;0;0;3284;8;460458.0
4;2.25;2690;2.0;0;0;2690;9;460000.0
4;2.5;2580;2.0;0;0;2580;9;865000.0
4;2.25;2330;1.0;0;0;2330;8;375000.0
4;3.5;4280;2.0;0;0;4280;11;1600000.0
3;2.0;1320;1.0;0;0;1320;7;251750.0
4;2.25;2130;2.0;0;0;2130;7;445000.0
4;2.25;3070;2.0;0;0;3070;8;600000.0
5;3.25;2590;1.0;0;0;2590;9;1500000.0
3;1.0;1140;1.0;0;0;1140;7;172500.0
3;1.0;960;1.0;0;0;960;5;225000.0
4;3.25;4060;2.0;0;0;4060;9;880000.0
4;1.5;1700;1.0;0;0;1700;7;502000.0
3;2.25;1660;2.0;0;0;1660;7;254000.0
4;2.5;1750;1.0;0;510;1240;7;335000.0
2;1.5;1160;2.0;0;270;890;7;284900.0
3;2.5;1540;1.0;0;770;770;7;485000.0
4;2.5;3180;2.0;0;1060;2120;8;523000.0
3;1.0;970;1.0;0;0;970;7;242000.0
4;4.0;3430;2.0;0;1040;2390;10;832500.0
4;2.5;2430;2.0;0;0;2430;8;310000.0
3;2.0;2140;2.0;0;460;1680;8;625000.0
3;1.75;1720;1.5;0;450;1270;7;565000.0
4;4.0;3970;2.0;0;0;3970;9;949990.0
4;1.75;3720;1.0;0;1760;1960;9;1275000.0
2;1.0;1290;1.0;0;0;1290;7;600000.0
5;2.75;1940;2.0;0;0;1940;7;577000.0
4;2.75;3620;2.0;0;0;3620;10;680000.0
3;2.0;2100;1.0;0;0;2100;9;740000.0
3;2.5;1520;3.0;0;0;1520;8;385000.0
2;2.25;1800;2.0;0;0;1800;9;472000.0
4;2.25;2180;1.0;0;810;1370;8;830000.0
2;1.0;900;1.0;0;0;900;7;473000.0
3;1.75;1840;1.0;0;0;1840;8;550000.0
3;1.5;1410;1.0;0;0;1410;8;367500.0
4;3.5;2700;2.0;0;780;1920;11;810000.0
3;1.0;1120;1.0;0;0;1120;6;401000.0
3;2.0;1670;1.0;0;0;1670;7;180000.0
3;1.5;1310;2.0;0;0;1310;7;398000.0
3;2.5;1500;2.0;0;300;1200;9;649950.0
2;1.0;900;1.0;0;120;780;6;529500.0
6;2.5;3010;2.0;0;0;3010;8;847000.0
5;1.75;1570;2.0;0;0;1570;7;530000.0
3;2.5;2030;3.0;0;0;2030;9;906000.0
3;2.5;1630;2.0;0;310;1320;8;419900.0
3;2.5;3090;2.0;0;0;3090;9;567500.0
4;3.25;2860;2.0;0;880;1980;9;825050.0
2;1.0;820;3.0;0;0;820;8;339950.0
2;1.0;1160;1.0;0;0;1160;7;175000.0
2;1.0;700;1.0;0;0;700;6;328000.0
5;3.25;3160;2.0;0;980;2180;10;957000.0
2;1.0;840;1.0;0;0;840;7;130000.0
4;2.75;2910;1.0;0;790;2120;9;485000.0
3;1.0;1510;1.0;0;340;1170;8;310000.0
4;2.0;2720;2.0;0;480;2240;8;560000.0
4;2.5;2350;2.0;0;0;2350;8;367000.0
3;2.5;1950;2.0;0;0;1950;9;899000.0
5;1.75;2150;1.0;0;690;1460;7;279950.0
4;3.5;5050;2.0;0;1440;3610;11;2320000.0
3;1.75;1890;1.0;0;0;1890;7;275000.0
5;3.25;2910;2.0;0;870;2040;8;515000.0
4;3.25;2190;2.0;0;650;1540;9;920000.0
4;4.5;3850;2.0;0;850;3000;10;995000.0
2;2.0;1100;1.5;0;0;1100;7;450000.0
4;2.75;2560;1.0;0;1060;1500;7;485000.0
3;1.75;1090;1.5;0;0;1090;8;292000.0
3;2.0;1560;1.0;0;410;1150;7;549000.0
2;1.75;1050;1.5;0;0;1050;6;295000.0
4;2.5;2910;2.0;0;0;2910;9;499950.0
3;2.5;1970;2.0;0;0;1970;8;280000.0
4;2.5;2390;2.0;0;0;2390;9;664000.0
4;2.25;2270;1.0;0;980;1290;7;446000.0
3;1.75;1260;2.0;0;0;1260;8;350000.0
4;2.25;2030;1.0;0;650;1380;8;500000.0
3;2.5;1900;2.0;0;0;1900;8;552775.0
3;2.25;1660;2.0;0;0;1660;7;269950.0
6;1.75;2400;1.5;0;1000;1400;7;499000.0
3;3.25;1210;2.0;0;210;1000;8;350000.0
4;1.0;1720;1.5;0;520;1200;7;547000.0
1;2.25;2140;1.0;0;670;1470;7;458000.0
4;2.25;1960;2.0;0;0;1960;7;490000.0
4;2.25;2240;2.0;0;0;2240;8;327500.0
4;2.75;3410;2.0;0;0;3410;9;545000.0
1;2.0;1240;2.0;0;0;1240;6;290000.0
6;2.75;2520;1.0;0;1200;1320;7;410000.0
3;1.0;1040;1.0;0;240;800;6;183500.0
5;3.5;3290;2.0;0;620;2670;9;775000.0
3;2.0;1680;1.0;0;0;1680;7;289000.0
3;1.0;1100;1.5;0;0;1100;6;465000.0
5;3.0;2970;2.0;0;0;2970;9;726888.0
2;1.0;910;1.0;0;0;910;6;280000.0
4;2.5;2632;2.0;0;0;2632;8;349950.0
4;2.5;3470;2.0;0;0;3470;10;994000.0
3;2.5;1950;2.0;0;0;1950;7;315000.0
3;1.75;1390;1.0;0;530;860;6;270000.0
3;1.5;2390;1.5;0;700;1690;9;978000.0
4;2.5;2480;2.0;0;0;2480;7;599000.0
4;2.5;3030;1.0;0;1370;1660;8;465000.0
2;2.25;1550;2.0;0;0;1550;8;328000.0
4;2.75;2470;1.0;0;900;1570;9;1205000.0
4;1.75;3080;1.5;0;0;3080;7;365000.0
5;2.5;3004;2.0;0;0;3004;9;398000.0
4;2.5;2350;2.5;0;0;2350;7;400000.0
3;2.75;2550;2.0;0;570;1980;8;590000.0
3;1.0;1200;1.0;0;0;1200;7;369500.0
3;2.0;1150;1.0;0;0;1150;7;382500.0
4;2.5;2360;1.0;0;900;1460;7;362000.0
3;1.75;1620;1.0;0;510;1110;7;680000.0
3;1.0;1090;1.0;0;0;1090;7;140000.0
3;1.5;1000;1.0;0;0;1000;6;196000.0
3;1.5;1060;1.0;0;0;1060;6;310000.0
4;1.0;1520;1.5;0;0;1520;7;160000.0
3;3.25;1560;2.0;0;300;1260;8;448000.0
3;1.5;1500;1.0;0;0;1500;7;270000.0
4;3.25;2950;2.0;0;740;2210;10;839704.0
3;2.5;2460;1.0;0;940;1520;8;464000.0
4;2.0;1490;1.5;0;0;1490;7;607000.0
2;2.25;1530;3.0;0;50;1480;8;520000.0
3;2.5;1740;2.0;0;0;1740;7;335000.0
2;1.75;1210;1.0;0;0;1210;7;342500.0
4;3.25;4160;2.0;0;1400;2760;8;530000.0
3;2.75;2990;2.0;0;0;2990;9;785000.0
2;1.0;1200;1.0;0;0;1200;7;231500.0
3;2.0;2160;1.0;0;0;2160;8;987000.0
4;1.75;2330;1.0;0;0;2330;8;390000.0
3;1.75;1410;2.0;0;0;1410;8;267800.0
3;2.5;1920;2.0;0;0;1920;7;372000.0
3;2.5;2056;2.0;0;0;2056;7;303000.0
4;2.0;1910;1.0;0;850;1060;7;493000.0
4;2.0;1700;1.0;0;850;850;7;220000.0
3;2.0;1680;1.0;0;800;880;6;258000.0
3;1.0;1510;1.5;0;0;1510;7;545000.0
3;2.5;2670;2.0;0;0;2670;9;810000.0
3;2.5;2210;2.0;0;500;1710;7;426000.0
3;3.0;2560;2.0;0;450;2110;10;925000.0
3;1.0;1030;1.0;0;0;1030;7;332500.0
2;1.0;2410;2.0;0;480;1930;9;725000.0
2;1.0;770;1.0;0;0;770;7;257000.0
5;2.75;2580;1.0;0;850;1730;7;915000.0
2;1.0;980;1.0;0;0;980;6;452000.0
3;2.5;1770;2.0;0;0;1770;7;183750.0
3;2.0;1760;1.0;0;660;1100;7;215000.0
3;1.5;1380;1.0;0;300;1080;7;525000.0
5;2.5;2080;1.0;0;620;1460;7;474950.0
4;3.0;5940;2.0;0;990;4950;11;1149000.0
6;3.5;6563;2.0;0;1410;5153;10;1300000.0
3;2.0;2010;2.0;0;0;2010;9;699000.0
4;3.0;2253;2.0;0;0;2253;7;385000.0
4;1.0;1450;1.0;0;0;1450;7;435000.0
3;1.0;1590;2.0;0;0;1590;7;323000.0
33;1.75;1620;1.0;0;580;1040;7;640000.0
5;2.25;2700;2.0;0;0;2700;9;898000.0
3;2.5;2270;2.0;0;0;2270;9;575000.0
3;2.0;1390;1.0;0;260;1130;7;190500.0
3;2.5;2600;1.0;0;900;1700;9;790000.0
3;2.0;1490;1.0;0;0;1490;8;289999.0
3;2.5;2460;2.0;0;0;2460;8;305000.0
3;1.75;1320;1.0;0;0;1320;7;243000.0
2;1.5;1020;3.0;0;0;1020;8;290000.0
4;2.25;2430;1.0;0;0;2430;9;590000.0
3;1.75;1240;1.0;0;0;1240;7;345000.0
3;2.5;1910;2.0;0;0;1910;9;650000.0
4;2.0;1760;1.0;0;700;1060;7;247500.0
6;4.5;3560;2.0;0;0;3560;7;389000.0
4;2.5;2150;1.0;0;910;1240;7;344900.0
2;1.75;1590;1.5;0;270;1320;9;850000.0
5;3.0;3110;2.0;0;0;3110;8;588000.0
4;1.75;1770;1.0;0;600;1170;7;507000.0
3;1.0;1870;1.0;0;750;1120;7;499950.0
3;1.0;1210;1.0;0;0;1210;7;290000.0
3;2.25;1270;2.0;0;230;1040;8;467000.0
3;1.0;1160;1.0;0;0;1160;7;330000.0
4;1.75;2930;1.0;0;1260;1670;9;840000.0
4;2.5;2340;2.0;0;0;2340;9;539000.0
2;1.5;901;3.0;0;0;901;7;435000.0
3;1.0;1010;1.0;0;0;1010;7;245000.0
3;2.0;1170;1.0;0;0;1170;7;250000.0
4;3.0;2350;1.0;0;860;1490;8;625000.0
2;2.5;2280;1.0;0;0;2280;8;752500.0
3;1.75;1650;2.0;0;350;1300;8;422250.0
3;2.5;1580;2.0;0;0;1580;7;325000.0
3;2.0;1430;1.0;0;0;1430;7;246500.0
4;2.5;3420;2.0;0;0;3420;9;640000.0
4;1.75;1700;1.0;0;850;850;7;378500.0
6;2.0;1900;1.0;0;700;1200;7;305000.0
5;2.25;2060;1.0;0;740;1320;7;509500.0
3;1.0;1320;1.0;0;440;880;6;232500.0
3;2.5;2740;2.0;0;0;2740;9;400000.0
2;1.0;720;1.0;0;0;720;6;199000.0
4;2.0;2520;1.0;0;1120;1400;8;875000.0
5;3.0;3300;1.0;0;1430;1870;9;1505000.0
4;3.25;3526;2.0;0;0;3526;10;911000.0
4;2.5;2990;2.0;0;0;2990;9;594491.0
2;1.0;880;1.0;0;0;880;5;292500.0
3;2.25;3440;2.0;0;1250;2190;10;740000.0
2;2.25;1430;2.0;0;90;1340;8;522500.0
4;3.0;2110;1.5;0;470;1640;7;610000.0
3;1.75;1330;1.0;0;0;1330;7;180000.0
2;2.25;1890;2.0;0;280;1610;8;750000.0
2;1.0;1060;1.5;0;0;1060;6;435000.0
3;1.0;1760;1.0;0;710;1050;7;444950.0
3;2.25;1900;1.0;0;680;1220;8;440000.0
3;2.5;1860;2.0;0;0;1860;7;280000.0
3;1.75;1730;1.0;0;0;1730;7;292000.0
4;1.75;2350;1.0;0;0;2350;8;620000.0
3;2.5;1970;2.0;0;0;1970;7;432000.0
4;2.0;1670;1.0;0;0;1670;7;204700.0
4;3.75;3600;1.0;0;0;3600;9;1925000.0
3;2.5;1920;2.0;0;0;1920;9;1011000.0
3;2.5;2060;2.0;0;0;2060;8;323800.0
2;1.0;1210;1.5;0;0;1210;7;402000.0
3;2.5;2050;2.0;0;0;2050;8;394950.0
5;2.75;2400;1.0;0;950;1450;7;325000.0
4;1.5;2180;1.0;0;900;1280;6;273000.0
4;4.0;4050;2.0;0;690;3360;11;1195000.0
4;2.5;2580;2.0;0;0;2580;8;880000.0
3;2.0;1030;1.0;0;0;1030;6;260000.0
3;2.25;2520;1.0;0;0;2520;10;598500.0
3;1.75;1610;1.0;0;510;1100;7;203000.0
4;2.5;1560;1.5;0;0;1560;7;511100.0
3;1.75;1780;1.0;0;490;1290;7;442573.0
2;1.0;750;1.0;0;0;750;6;310000.0
3;1.75;1170;1.0;0;0;1170;7;205000.0
3;1.0;1150;1.0;0;0;1150;7;358000.0
3;1.75;1370;1.0;0;0;1370;7;301950.0
3;2.0;1720;1.0;0;0;1720;7;427000.0
4;2.25;1950;1.0;0;620;1330;8;895000.0
3;1.0;1200;1.0;0;0;1200;6;190000.0
2;1.0;920;1.0;0;0;920;6;229950.0
2;2.0;1440;1.0;0;0;1440;8;457000.0
3;1.75;1490;1.0;0;0;1490;7;350000.0
4;2.0;2470;1.5;0;500;1970;6;339000.0
3;3.25;2240;2.0;0;700;1540;9;279900.0
4;2.75;3520;1.0;1;1570;1950;9;1662000.0
4;2.5;2240;2.0;0;0;2240;8;331210.0
3;2.5;2420;1.0;0;890;1530;8;475000.0
3;1.75;2260;1.0;0;1130;1130;7;467500.0
2;1.0;850;1.0;0;0;850;7;553500.0
3;3.5;4310;2.0;0;1170;3140;10;1200000.0
4;1.5;2890;2.0;0;800;2090;8;910000.0
5;1.0;1710;1.5;0;390;1320;7;560000.0
1;0.75;940;1.0;0;0;940;6;250000.0
3;2.0;1550;1.5;0;0;1550;7;320000.0
4;2.75;3670;2.0;0;0;3670;10;1218000.0
3;1.5;1860;1.0;0;660;1200;7;288350.0
4;1.75;2480;1.0;0;1090;1390;7;780000.0
2;1.75;1080;2.0;0;0;1080;7;350000.0
4;2.5;3350;2.0;0;0;3350;9;720500.0
4;2.25;2350;2.0;0;0;2350;9;1620000.0
3;1.0;920;1.0;0;0;920;6;208000.0
4;1.75;1560;1.0;0;0;1560;7;544300.0
3;2.5;2080;1.0;0;380;1700;8;689000.0
3;2.5;1650;2.0;0;0;1650;8;424950.0
3;1.75;2430;1.0;0;1090;1340;8;1500000.0
4;2.5;2880;1.0;0;0;2880;10;845000.0
3;1.0;1120;1.0;0;0;1120;7;365000.0
4;2.5;3600;2.0;0;0;3600;9;760000.0
1;1.0;780;1.5;0;0;780;6;167000.0
3;1.75;1540;1.0;0;290;1250;7;630000.0
3;1.5;1420;1.0;0;0;1420;6;136500.0
3;1.5;1360;2.0;0;240;1120;7;396500.0
2;1.75;1350;1.0;0;0;1350;8;430000.0
4;3.25;3420;2.0;0;390;3030;9;635000.0
3;1.5;1510;1.0;0;0;1510;7;275000.0
3;1.75;1350;1.0;0;0;1350;6;300000.0
3;2.25;1790;1.0;0;550;1240;7;650000.0
3;1.75;1120;1.0;0;0;1120;7;249950.0
3;1.5;2000;1.0;0;0;2000;8;560000.0
3;1.75;1840;1.0;0;900;940;7;645000.0
4;2.75;1830;1.0;0;510;1320;7;485000.0
3;2.5;2480;2.0;0;0;2480;9;390000.0
4;2.5;2170;1.0;0;710;1460;7;550000.0
3;1.75;1070;1.0;0;0;1070;7;208000.0
4;2.25;3490;2.0;0;1210;2280;10;1225000.0
3;2.5;1350;2.0;0;270;1080;7;270000.0
4;3.5;3200;2.0;0;0;3200;9;490000.0
5;3.5;2160;3.0;0;0;2160;9;750000.0
3;1.0;1260;1.0;0;0;1260;6;120000.0
4;2.5;2340;2.0;0;0;2340;9;597000.0
5;2.5;5067;1.0;0;1913;3154;9;452000.0
4;2.5;3180;2.0;0;0;3180;9;960000.0
4;4.5;5770;1.0;0;2610;3160;9;1535000.0
4;2.25;1750;1.0;0;430;1320;8;542500.0
3;2.5;2070;2.0;0;0;2070;8;535000.0
4;1.5;2120;1.0;0;950;1170;7;249500.0
3;2.25;1900;1.0;0;620;1280;7;212000.0
2;1.0;790;1.0;0;0;790;6;342888.0
3;3.0;2470;2.0;0;0;2470;8;525000.0
2;1.5;950;3.0;0;0;950;8;396000.0
1;0.75;560;1.0;0;0;560;4;299000.0
3;2.5;2510;1.5;0;0;2510;10;1950000.0
5;2.5;2510;1.5;0;800;1710;7;400000.0
5;2.25;2900;1.0;0;1450;1450;8;675000.0
4;2.0;1890;1.5;0;400;1490;7;805000.0
3;2.5;2420;1.0;0;800;1620;9;755000.0
4;1.75;2340;1.0;0;980;1360;7;476000.0
2;1.5;1000;3.0;0;0;1000;8;424950.0
5;2.5;4250;1.0;0;1760;2490;11;1810000.0
4;1.5;1890;1.0;0;0;1890;7;319990.0
3;1.0;1190;1.0;0;0;1190;6;319500.0
4;3.25;3080;2.0;0;700;2380;9;1280000.0
4;1.75;1670;1.0;0;0;1670;8;697000.0
2;1.0;870;1.0;0;0;870;7;382000.0
2;2.75;1430;2.0;0;435;995;7;465000.0
4;3.0;3900;1.0;0;1380;2520;10;1620000.0
2;1.0;910;1.0;0;0;910;5;85000.0
3;2.0;2020;1.0;0;1010;1010;7;420000.0
3;2.5;1770;2.0;0;0;1770;7;245000.0
2;2.0;1190;1.0;0;0;1190;6;210000.0
3;1.0;1290;1.5;0;0;1290;7;402500.0
3;2.5;2660;2.0;0;0;2660;8;599950.0
5;2.5;3670;1.5;0;0;3670;8;731000.0
3;1.75;2140;1.0;0;920;1220;8;577500.0
4;2.5;2518;2.0;0;0;2518;8;643000.0
3;1.5;1090;1.0;0;0;1090;7;698000.0
2;1.0;970;1.0;0;0;970;7;210000.0
3;1.0;920;1.0;0;0;920;6;207000.0
4;2.25;2430;2.0;0;0;2430;8;330000.0
3;2.75;2690;1.0;0;0;2690;9;829000.0
4;2.5;2180;2.0;0;0;2180;8;726500.0
2;1.0;810;1.0;0;0;810;7;357950.0
3;2.0;1760;1.5;0;220;1540;7;750000.0
3;1.75;1100;1.0;0;0;1100;7;229900.0
2;2.25;2160;2.0;1;0;2160;9;1200000.0
2;1.5;2440;2.0;0;850;1590;7;662700.0
2;1.75;1290;2.0;0;0;1290;8;239800.0
3;2.0;1900;1.0;0;0;1900;7;252500.0
4;2.5;3030;1.0;0;650;2380;9;1470000.0
3;1.75;1760;1.5;0;0;1760;7;688500.0
2;1.0;930;1.0;0;0;930;6;290000.0
3;2.25;1970;1.0;0;790;1180;8;465000.0
4;2.5;2610;2.0;0;0;2610;8;335000.0
2;1.0;930;1.0;0;0;930;7;420000.0
5;2.5;2170;2.0;0;0;2170;8;359800.0
3;2.0;2070;1.0;0;620;1450;7;254000.0
2;2.25;1280;2.0;0;200;1080;7;370000.0
3;2.5;2720;1.0;0;680;2040;8;550000.0
3;2.0;1670;1.5;0;0;1670;8;585000.0
4;1.5;1860;1.0;0;0;1860;7;443000.0
4;2.5;2450;2.0;0;0;2450;9;555000.0
3;2.25;1445;2.0;0;145;1300;7;366000.0
2;1.0;1310;1.0;0;0;1310;6;280000.0
1;2.0;1070;2.0;0;190;880;8;420000.0
4;3.0;2320;2.0;0;0;2320;7;310000.0
4;3.25;2730;1.0;0;1170;1560;9;625000.0
4;2.5;1900;2.0;0;0;1900;8;425000.0
3;3.5;2800;1.0;0;0;2800;9;920000.0
5;4.0;3400;2.0;0;1080;2320;8;870000.0
4;1.75;2190;1.0;0;0;2190;8;450000.0
4;2.5;2680;2.0;0;0;2680;8;437500.0
5;2.0;1860;2.0;0;0;1860;7;338000.0
4;1.75;1940;1.0;0;0;1940;8;252000.0
3;1.75;1850;1.5;0;0;1850;6;572000.0
3;2.25;1650;1.0;0;390;1260;7;385000.0
6;2.0;2800;1.0;0;1400;1400;7;405000.0
4;1.0;1120;1.0;0;0;1120;6;227000.0
4;1.5;1530;1.0;0;0;1530;6;299800.0
4;2.0;2680;1.0;0;0;2680;8;360000.0
4;2.75;3220;2.0;0;0;3220;8;579000.0
3;1.0;1540;1.5;0;340;1200;7;530100.0
3;2.25;2950;1.0;0;1430;1520;8;1065500.0
2;1.0;810;1.0;0;0;810;6;170000.0
3;1.5;1320;1.0;0;0;1320;8;650000.0
3;1.5;1620;1.0;0;0;1620;8;780000.0
3;2.75;2470;2.0;0;0;2470;8;970500.0
5;3.0;2920;2.0;0;780;2140;8;830000.0
2;1.5;988;3.0;0;0;988;7;295000.0
4;2.5;2800;2.0;0;0;2800;9;752875.0
4;3.5;3620;2.5;0;0;3620;9;825000.0
4;2.5;3270;2.0;0;0;3270;10;797500.0
3;3.5;3500;2.0;0;0;3500;10;797000.0
2;1.5;1110;3.0;0;0;1110;8;371000.0
4;2.5;2910;2.0;0;0;2910;9;810000.0
4;2.5;2980;2.0;0;0;2980;8;382500.0
3;2.25;2580;1.0;0;950;1630;7;340000.0
4;1.75;2290;1.0;0;900;1390;7;326000.0
4;2.75;2700;2.0;0;0;2700;9;515000.0
4;2.75;3430;1.5;0;0;3430;8;367999.0
3;2.5;1990;2.0;0;0;1990;8;545000.0
2;1.75;2040;1.0;0;0;2040;7;499000.0
5;1.0;1600;1.0;0;0;1600;7;260000.0
3;3.0;2500;2.0;0;0;2500;8;432500.0
3;2.5;2020;2.0;0;0;2020;7;309900.0
4;3.25;3450;2.0;0;0;3450;9;852880.0
3;2.5;1950;2.0;0;0;1950;7;315000.0
3;1.0;1800;1.0;0;0;1800;7;265000.0
4;2.5;2440;2.0;0;0;2440;9;562500.0
5;2.25;3550;2.0;0;0;3550;8;575000.0
4;2.5;2200;2.0;0;0;2200;8;460000.0
4;1.0;1820;1.5;0;0;1820;8;1010000.0
5;2.5;2510;1.0;0;1100;1410;8;450000.0
4;2.5;3160;1.5;0;1140;2020;9;1280000.0
5;2.5;3220;2.0;0;0;3220;8;355000.0
4;4.25;4390;2.0;0;1070;3320;10;1050000.0
4;3.5;3950;2.0;0;0;3950;10;860000.0
2;1.75;2050;1.5;0;0;2050;8;825000.0
8;3.5;4440;2.0;0;1300;3140;10;1970000.0
4;2.5;2690;2.0;0;0;2690;9;620000.0
4;3.5;4020;2.0;0;0;4020;11;1691000.0
4;2.5;1980;2.0;0;0;1980;7;357000.0
4;4.75;5310;2.0;0;0;5310;11;1365000.0
3;3.5;3380;3.0;0;580;2800;10;1190000.0
4;2.0;1810;2.0;0;110;1700;8;575000.0
5;2.25;4200;2.5;0;1290;2910;9;1335000.0
4;2.5;2360;1.0;0;580;1780;8;600000.0
4;2.25;3960;2.0;0;1330;2630;9;1395710.0
4;2.25;1890;1.0;0;0;1890;8;545000.0
3;2.5;2330;2.0;0;0;2330;9;660000.0
4;2.5;2530;2.0;0;0;2530;8;417838.0
4;3.25;2840;2.0;0;510;2330;9;535000.0
3;2.5;2240;2.0;0;0;2240;7;432500.0
3;2.0;1310;1.0;0;0;1310;7;196500.0
3;2.75;2500;1.0;0;920;1580;7;397900.0
3;2.25;1190;1.0;0;0;1190;7;445000.0
3;1.0;1060;1.0;0;0;1060;7;230000.0
4;1.0;1360;1.5;0;0;1360;6;560000.0
3;2.25;1445;2.0;0;145;1300;7;387000.0
4;2.5;2230;2.0;0;0;2230;7;415000.0
3;1.75;1300;1.5;0;0;1300;6;515000.0
3;2.5;2110;2.0;0;0;2110;8;355000.0
4;2.5;3330;2.0;0;0;3330;10;936000.0
3;2.5;2080;2.0;0;0;2080;8;567500.0
3;2.0;1770;1.0;0;670;1100;7;423500.0
2;2.0;1510;1.0;0;0;1510;8;450000.0
6;3.0;2180;2.0;0;0;2180;7;230000.0
3;2.5;1350;2.0;0;230;1120;8;468500.0
3;3.25;3660;2.0;0;0;3660;10;920000.0
4;2.0;1790;1.0;0;0;1790;8;570000.0
3;1.0;1110;1.5;0;0;1110;7;532000.0
2;2.0;1340;2.0;0;0;1340;8;376000.0
2;1.0;1160;1.0;0;250;910;7;605125.0
3;1.5;2200;1.0;0;1070;1130;7;515000.0
4;2.25;2130;2.0;0;0;2130;8;802000.0
3;2.0;3000;1.0;0;1500;1500;8;400000.0
5;2.5;2350;2.0;0;0;2350;9;910000.0
3;2.25;2030;2.0;0;0;2030;8;520000.0
2;2.5;1480;3.0;0;0;1480;7;420000.0
3;2.0;2520;1.5;0;1110;1410;8;840500.0
3;1.0;1600;1.0;0;0;1600;7;325000.0
4;2.5;3305;1.5;0;1060;2245;7;492000.0
3;1.75;2010;1.0;0;0;2010;8;639500.0
2;3.0;1160;2.0;0;280;880;7;405000.0
4;2.5;3560;2.0;0;0;3560;10;1364000.0
4;2.5;2650;2.0;0;0;2650;8;398651.0
5;3.5;2780;2.0;0;600;2180;8;475000.0
4;2.0;1870;1.0;0;0;1870;7;245000.0
4;2.5;2450;2.0;0;0;2450;7;340000.0
4;3.25;3410;2.0;0;940;2470;9;585000.0
3;1.5;2210;1.5;0;0;2210;8;799000.0
5;3.5;2790;2.0;0;820;1970;10;738000.0
4;3.5;2780;2.0;0;660;2120;8;870000.0
3;2.5;2120;1.0;0;900;1220;7;248000.0
3;1.75;1600;1.0;0;550;1050;7;442500.0
3;2.5;2510;2.0;0;0;2510;7;535000.0
4;2.5;1975;2.0;0;0;1975;7;311000.0
3;1.5;1430;1.0;0;0;1430;7;280000.0
3;2.25;1870;1.0;0;480;1390;7;350500.0
3;1.75;1680;1.0;0;280;1400;7;550000.0
4;3.0;2800;2.0;0;0;2800;8;449950.0
3;2.5;1370;2.0;0;0;1370;7;231000.0
4;1.75;2500;1.0;0;900;1600;8;587500.0
3;2.5;1320;2.0;0;440;880;7;221000.0
4;2.5;3280;2.0;0;0;3280;7;671300.0
3;1.0;1210;1.0;0;0;1210;6;219950.0
3;2.25;1630;2.0;0;0;1630;7;468000.0
3;1.0;1170;1.0;0;0;1170;6;216500.0
3;3.25;1680;2.0;0;320;1360;8;399000.0
5;4.0;4460;2.0;0;1130;3330;9;833450.0
3;2.0;1290;3.0;0;0;1290;7;310000.0
3;2.5;3240;2.0;0;0;3240;10;651000.0
4;2.5;2700;2.0;0;0;2700;9;426500.0
3;1.0;1510;1.0;0;0;1510;7;239000.0
4;3.5;4390;2.0;0;1330;3060;11;1610000.0
4;3.5;3790;2.5;0;0;3790;9;875000.0
3;1.5;1700;1.0;0;570;1130;7;950000.0
3;1.0;800;1.0;0;100;700;6;265000.0
3;2.25;1810;2.0;0;0;1810;7;257000.0
3;1.5;2220;2.0;0;430;1790;9;1101000.0
3;1.0;990;1.0;0;150;840;7;399000.0
3;1.75;1210;1.0;0;0;1210;7;460000.0
4;1.0;1960;1.5;0;0;1960;6;371000.0
4;2.0;3090;2.5;0;0;3090;8;1220000.0
5;3.0;4780;1.0;0;1120;3660;10;2575000.0
4;3.25;3266;2.0;0;0;3266;8;418000.0
2;1.0;950;1.0;0;0;950;7;550000.0
4;2.5;3620;2.0;0;0;3620;10;900000.0
3;2.5;1970;2.0;0;880;1090;7;289000.0
4;1.75;2140;1.0;0;1070;1070;7;565000.0
3;1.5;1580;1.0;0;500;1080;7;249000.0
3;1.75;1370;1.0;0;0;1370;8;235000.0
4;2.5;2320;2.0;0;0;2320;8;397000.0
2;1.0;1100;1.0;0;0;1100;7;343566.0
4;2.25;2270;1.0;0;980;1290;7;304999.0
3;1.0;1230;1.0;0;0;1230;7;839000.0
2;2.5;3900;2.0;0;0;3900;12;1998000.0
4;2.25;3780;2.0;0;1270;2510;9;1400000.0
3;1.75;2030;1.0;0;0;2030;8;395000.0
3;1.0;1250;1.0;0;0;1250;6;294000.0
5;2.75;3040;2.0;0;0;3040;10;960000.0
3;2.0;2040;1.0;0;1230;810;6;245000.0
3;1.75;2340;1.0;0;0;2340;8;600000.0
3;2.5;1970;1.0;1;870;1100;8;1175000.0
4;2.0;2060;2.0;0;0;2060;7;400000.0
3;2.0;1350;1.0;0;0;1350;7;244000.0
3;2.0;1610;1.0;0;350;1260;7;435000.0
2;1.0;900;1.0;0;0;900;7;355000.0
4;1.5;2550;1.5;0;790;1760;7;645000.0
6;4.0;3180;2.0;0;0;3180;9;859950.0
3;1.5;1940;1.0;0;800;1140;7;232500.0
3;1.75;2520;1.0;0;1060;1460;9;849000.0
4;2.25;2220;1.0;0;1110;1110;8;495000.0
5;2.25;2610;2.0;0;860;1750;7;678940.0
6;2.5;3370;1.0;0;1600;1770;8;570000.0
2;2.0;990;1.0;0;0;990;6;600000.0
3;2.5;1620;1.0;0;0;1620;6;299000.0
4;2.5;2650;2.0;0;0;2650;9;329000.0
3;2.25;1230;2.0;0;150;1080;8;435000.0
3;1.5;1660;1.0;0;450;1210;7;515000.0
4;1.75;2290;1.5;0;600;1690;7;449999.0
3;2.5;2970;2.0;0;0;2970;9;499500.0
3;1.75;1700;2.0;0;0;1700;7;300000.0
2;1.0;790;1.0;0;0;790;7;130000.0
5;1.75;2130;1.0;0;630;1500;8;1300000.0
4;2.5;2990;1.0;0;890;2100;8;1110000.0
4;2.75;2620;2.0;0;0;2620;8;475000.0
3;2.0;1290;1.0;0;0;1290;7;215000.0
2;1.0;1380;1.0;0;500;880;8;450000.0
4;2.5;2750;2.0;0;0;2750;10;812500.0
3;1.5;1460;1.0;0;0;1460;7;310000.0
5;3.0;4480;2.5;0;1060;3420;12;1990000.0
5;2.5;2200;1.0;0;800;1400;7;320900.0
4;2.0;1690;1.5;0;140;1550;7;487250.0
2;1.5;1480;1.0;0;0;1480;7;280000.0
3;1.75;1440;1.0;0;0;1440;7;239950.0
4;2.5;3220;1.5;0;0;3220;8;590000.0
3;1.75;2060;1.5;0;880;1180;7;595000.0
3;1.5;1240;1.0;0;0;1240;7;355000.0
2;1.0;910;1.0;0;0;910;6;254000.0
3;2.5;1730;2.0;0;0;1730;7;187000.0
4;2.5;3520;2.0;0;0;3520;9;760000.0
4;2.5;3020;1.5;0;1000;2020;9;975000.0
3;2.5;1630;2.0;0;0;1630;8;422120.0
4;3.5;2970;2.0;0;710;2260;8;549995.0
4;3.5;4420;2.0;0;1070;3350;10;730000.0
4;2.5;2840;1.0;0;1420;1420;8;814000.0
4;2.5;1950;2.0;0;0;1950;7;299000.0
4;2.5;3320;2.0;0;0;3320;10;1108000.0
4;2.0;2030;1.5;0;600;1430;6;253779.0
4;2.5;1900;2.0;0;0;1900;7;335000.0
6;3.0;2290;2.0;0;0;2290;7;420000.0
3;1.75;1230;1.0;0;0;1230;7;220000.0
3;2.5;1600;2.0;0;0;1600;7;205000.0
3;2.75;2240;2.0;0;140;2100;8;450000.0
4;1.0;1640;1.5;0;0;1640;6;519000.0
2;1.0;1790;1.5;0;300;1490;8;570000.0
3;2.5;3300;2.0;0;0;3300;9;850000.0
4;1.5;1840;2.0;0;0;1840;8;701000.0
2;1.0;1050;1.0;0;0;1050;7;245000.0
4;1.0;1040;1.5;0;0;1040;6;396000.0
2;2.5;3090;1.0;0;840;2250;10;602500.0
4;2.5;3260;1.0;0;1300;1960;8;538000.0
3;1.75;2290;1.0;0;670;1620;8;470000.0
5;2.5;2820;2.0;0;440;2380;7;669950.0
3;2.5;3120;2.0;0;0;3120;9;419950.0
5;2.5;2340;2.0;0;0;2340;7;392000.0
3;2.5;2290;2.0;0;0;2290;9;585000.0
3;3.5;1280;2.0;0;240;1040;8;470000.0
3;2.5;3260;2.0;0;0;3260;9;850000.0
2;1.0;1150;1.0;0;200;950;7;282000.0
3;3.25;1480;2.0;0;300;1180;8;312500.0
2;1.0;970;1.0;0;0;970;7;425000.0
3;2.25;3000;1.0;0;0;3000;10;850000.0
4;1.75;1970;1.0;0;830;1140;7;379950.0
3;2.0;1590;1.0;0;0;1590;7;485000.0
4;2.75;2980;1.0;0;1070;1910;8;505000.0
3;1.0;1200;1.0;0;0;1200;7;215000.0
4;2.5;2800;2.0;0;0;2800;9;739000.0
3;1.0;1300;2.0;0;0;1300;7;819000.0
2;1.0;720;1.0;0;0;720;5;150000.0
3;2.5;3030;1.5;0;0;3030;10;766950.0
2;1.5;1008;1.0;1;0;1008;6;480000.0
3;2.0;2420;1.0;0;1000;1420;7;298500.0
4;2.5;3650;1.0;1;1820;1830;9;2400000.0
3;1.5;1180;1.0;0;0;1180;7;250200.0
4;2.5;2009;2.0;0;0;2009;8;279000.0
4;2.5;2640;2.0;0;0;2640;8;389517.0
3;3.5;2100;2.0;0;0;2100;9;356000.0
3;1.75;1260;1.0;0;560;700;6;570000.0
2;1.0;750;1.0;0;0;750;6;238000.0
4;2.5;2460;2.0;0;0;2460;9;722500.0
3;1.5;1070;1.0;0;0;1070;6;219950.0
3;2.0;1900;1.0;0;400;1500;8;545000.0
4;2.25;1930;1.0;0;0;1930;8;289000.0
2;1.0;940;1.0;0;0;940;6;115000.0
3;2.0;2000;1.0;0;570;1430;8;423500.0
2;1.75;1130;1.0;0;0;1130;8;565000.0
3;1.75;1290;1.0;0;0;1290;7;275000.0
3;1.0;1500;2.0;0;0;1500;7;707500.0
4;2.5;2840;2.0;0;0;2840;8;339000.0
3;1.0;1210;1.0;0;0;1210;7;324950.0
4;2.25;2290;2.0;0;170;2120;9;975000.0
3;3.25;3020;2.0;0;0;3020;9;1400000.0
3;1.0;1250;1.0;0;0;1250;7;175000.0
3;1.5;1130;1.0;0;0;1130;7;280005.0
2;1.0;720;1.0;0;0;720;5;151000.0
3;2.5;1580;2.0;0;0;1580;7;375000.0
3;2.75;3530;2.0;0;0;3530;10;760000.0
3;1.0;1090;1.0;0;0;1090;7;365000.0
4;3.5;5550;2.0;0;2200;3350;12;3710000.0
3;2.25;2140;2.0;0;0;2140;7;400000.0
3;2.5;2600;1.5;1;450;2150;8;540000.0
4;1.75;1770;1.0;0;400;1370;8;606150.0
2;1.0;1020;1.0;0;0;1020;7;460000.0
4;2.5;3170;2.0;0;0;3170;9;660000.0
3;2.5;2480;2.0;0;0;2480;8;583800.0
4;1.0;1980;1.0;0;550;1430;7;395000.0
3;1.75;1960;1.0;0;980;980;6;415000.0
4;2.5;1867;2.0;0;0;1867;9;378950.0
3;2.5;1830;2.0;0;0;1830;7;286651.0
5;1.5;1930;2.0;0;0;1930;7;270000.0
3;2.5;1480;3.0;0;0;1480;8;650000.0
4;2.75;1800;1.0;0;750;1050;7;344500.0
4;2.5;1830;2.0;0;0;1830;7;312000.0
3;1.75;2590;1.0;0;1000;1590;8;485000.0
3;2.25;1610;1.0;0;330;1280;8;218000.0
3;1.5;1370;1.0;0;0;1370;7;185000.0
4;2.5;2370;2.0;0;0;2370;8;479000.0
4;2.5;2050;2.0;0;0;2050;8;320000.0
3;1.75;2000;1.0;0;520;1480;8;440000.0
3;1.75;1870;1.0;0;0;1870;8;314500.0
4;1.0;1200;1.5;0;0;1200;7;436000.0
2;1.0;1150;1.0;0;0;1150;7;324950.0
3;2.5;1400;1.0;0;200;1200;7;340000.0
3;1.75;2040;1.5;0;300;1740;8;620000.0
3;2.0;1880;1.0;0;700;1180;8;475000.0
4;3.25;4140;2.0;0;0;4140;10;1839900.0
4;3.5;5270;2.0;0;1830;3440;10;782000.0
3;2.5;2060;2.0;0;0;2060;8;533000.0
5;3.0;2240;1.0;0;0;2240;6;313500.0
4;2.0;1280;1.0;0;0;1280;6;249000.0
3;2.5;2780;1.5;0;670;2110;8;1140000.0
4;4.0;5610;3.0;0;860;4750;11;1583000.0
3;3.25;1651;2.0;0;310;1341;8;363000.0
5;2.75;2720;1.5;0;1010;1710;8;752500.0
1;0.0;600;1.0;0;0;600;3;280000.0
3;1.5;1460;1.0;0;0;1460;6;240000.0
3;2.5;1769;2.0;0;0;1769;9;334888.0
4;2.0;1970;1.5;0;840;1130;7;423000.0
3;1.75;1970;1.0;0;670;1300;8;678700.0
3;2.0;1340;1.0;0;670;670;6;335000.0
3;1.75;1280;1.0;0;250;1030;8;340000.0
4;2.5;3010;2.0;0;0;3010;9;568500.0
3;2.5;2390;2.0;0;420;1970;8;420000.0
3;1.75;2270;1.0;0;900;1370;7;292000.0
3;2.5;950;2.0;0;0;950;8;475000.0
3;2.5;3040;2.0;0;0;3040;10;790000.0
3;1.75;1480;1.0;0;0;1480;8;685000.0
3;2.5;2220;2.0;0;0;2220;8;325000.0
3;1.75;1500;1.0;0;0;1500;7;435000.0
3;2.5;3660;2.0;0;400;3260;9;530000.0
3;2.5;2600;1.0;0;1300;1300;8;748000.0
4;3.5;2980;2.0;0;640;2340;9;905000.0
2;1.75;1560;2.0;0;0;1560;8;295000.0
2;1.25;1240;2.0;0;0;1240;8;545000.0
4;2.0;1390;1.5;0;0;1390;7;425000.0
4;1.5;1370;1.5;0;0;1370;7;545000.0
3;2.25;2210;1.0;0;670;1540;7;245000.0
2;1.0;960;1.0;0;0;960;6;212625.0
4;2.0;1640;1.0;0;820;820;6;299999.0
3;1.0;1000;1.0;0;0;1000;7;217000.0
4;3.25;3910;2.0;0;780;3130;9;709950.0
2;1.0;1280;1.0;0;80;1200;7;649000.0
3;2.5;1870;2.0;0;0;1870;7;289950.0
5;2.0;1730;1.0;0;0;1730;6;249950.0
3;2.0;1480;1.0;0;740;740;7;385000.0
2;1.5;830;2.0;0;0;830;7;425000.0
3;2.0;1230;1.0;0;0;1230;7;475000.0
4;2.5;2670;2.0;0;0;2670;8;612000.0
2;1.0;1060;1.0;0;0;1060;7;515000.0
4;3.5;3880;2.0;0;820;3060;10;620000.0
2;1.0;1620;1.0;0;770;850;6;350000.0
3;1.0;1010;1.0;0;0;1010;7;300000.0
4;4.25;5660;2.0;0;1560;4100;10;955000.0
2;1.0;700;1.0;0;220;480;6;119900.0
4;1.75;1520;1.0;0;150;1370;7;533250.0
4;2.5;2480;2.0;0;0;2480;8;480000.0
3;1.0;950;1.0;0;0;950;7;365000.0
3;2.0;1460;2.0;0;0;1460;7;392137.0
3;1.0;1400;1.0;0;0;1400;6;246000.0
2;1.5;2060;1.0;0;870;1190;6;348140.0
4;2.5;3470;2.0;0;990;2480;9;1300000.0
4;2.0;1780;1.5;0;0;1780;8;1000000.0
5;1.75;2460;1.5;0;1120;1340;7;445000.0
5;3.75;4220;2.0;0;0;4220;11;1165000.0
3;1.75;1660;1.0;0;0;1660;7;315000.0
1;1.0;850;1.0;0;0;850;6;490000.0
5;2.5;2990;2.0;0;0;2990;9;625000.0
3;2.5;2740;2.0;0;0;2740;9;409000.0
5;4.5;4400;2.0;0;1010;3390;11;1800000.0
2;2.5;1160;2.0;0;120;1040;8;525000.0
3;1.0;1500;1.5;0;450;1050;7;530000.0
4;1.0;1360;1.0;0;340;1020;6;273500.0
4;3.25;4010;2.0;0;0;4010;11;972000.0
4;2.5;2710;2.0;0;0;2710;7;540000.0
4;2.5;1990;2.0;0;0;1990;7;264950.0
3;3.5;1494;3.0;0;0;1494;8;650000.0
4;2.25;2030;1.0;0;440;1590;7;545000.0
4;2.0;1650;1.0;0;890;760;7;402500.0
4;2.75;3160;2.0;0;850;2310;8;942000.0
2;1.0;1150;1.0;0;0;1150;7;376000.0
4;2.5;1847;2.0;0;0;1847;7;215000.0
5;3.75;3530;2.0;0;0;3530;10;1610000.0
3;1.0;1200;1.5;0;0;1200;6;398500.0
3;1.0;1580;1.0;0;540;1040;7;253000.0
3;2.75;2590;2.0;0;0;2590;10;695000.0
4;5.0;6055;1.0;0;2500;3555;12;1760000.0
4;4.25;4645;2.0;0;790;3855;10;1595000.0
2;1.0;1210;1.0;0;500;710;6;285000.0
3;2.5;1850;1.0;0;350;1500;7;249000.0
4;2.25;2170;2.0;0;0;2170;8;648000.0
3;2.0;2560;1.0;0;0;2560;8;560000.0
3;1.0;1570;1.5;0;0;1570;5;212644.0
2;1.0;2020;1.0;0;320;1700;7;720000.0
4;1.75;1610;1.0;0;0;1610;7;215000.0
3;2.0;1640;1.0;0;580;1060;7;319000.0
3;1.75;2760;1.0;0;1380;1380;7;465000.0
3;2.5;2330;2.0;0;0;2330;8;625000.0
4;2.5;3150;2.0;0;0;3150;9;475000.0
4;1.75;1920;1.0;0;750;1170;7;502000.0
3;2.25;1960;1.0;0;670;1290;7;182000.0
3;1.75;1410;1.0;0;300;1110;7;445000.0
4;2.25;3250;2.0;0;0;3250;9;480000.0
3;2.5;2010;2.0;0;0;2010;9;625000.0
5;3.5;3860;1.0;0;1200;2660;8;670000.0
4;2.0;1750;1.0;0;0;1750;6;240000.0
2;1.0;850;1.0;0;100;750;6;370000.0
5;2.25;2180;1.0;0;750;1430;8;635000.0
4;2.75;3260;1.0;0;1090;2170;10;1880000.0
4;2.5;3510;1.0;0;1580;1930;9;931088.0
4;1.5;1300;1.5;0;0;1300;7;287000.0
3;1.5;1150;2.0;0;0;1150;7;310000.0
3;2.0;2010;1.5;0;0;2010;8;415000.0
3;1.0;1450;1.0;0;300;1150;6;394000.0
3;1.75;1490;1.0;0;0;1490;7;310000.0
3;2.5;1530;2.0;0;0;1530;7;265000.0
5;1.5;1900;1.0;0;770;1130;7;415000.0
3;3.25;3960;2.0;0;1360;2600;10;1220000.0
4;2.5;2070;2.0;0;0;2070;8;255000.0
3;1.0;970;1.0;0;0;970;7;215000.0
2;1.0;950;1.0;0;0;950;6;193000.0
2;1.0;830;1.0;0;0;830;6;275000.0
4;1.5;1810;1.0;0;310;1500;7;799000.0
4;3.0;2320;2.0;0;160;2160;8;637500.0
5;2.0;2130;1.0;0;690;1440;7;344000.0
4;2.5;2490;2.0;0;0;2490;9;364900.0
2;1.0;880;1.0;0;0;880;7;372500.0
3;2.5;1820;1.0;0;600;1220;7;453000.0
2;3.0;1270;2.0;0;160;1110;8;531000.0
4;2.5;3160;2.0;0;0;3160;10;1190000.0
5;3.75;4320;2.0;1;0;4320;8;1800000.0
4;2.25;2130;2.0;0;0;2130;9;850000.0
3;1.75;1590;1.0;0;460;1130;7;250000.0
3;1.75;1390;1.0;0;0;1390;7;450000.0
3;1.0;1100;2.0;0;0;1100;7;400000.0
4;2.5;1900;2.0;0;0;1900;8;375000.0
3;2.0;1430;1.0;0;0;1430;7;465000.0
2;1.75;930;1.0;0;0;930;6;275000.0
3;2.5;2270;1.0;0;0;2270;10;716000.0
2;1.0;1040;1.0;0;0;1040;7;370000.0
5;3.25;3860;2.0;0;0;3860;9;820875.0
4;2.5;2350;2.0;0;0;2350;9;299000.0
3;1.75;2020;1.0;0;840;1180;7;475000.0
3;2.5;1572;2.0;0;0;1572;8;299000.0
4;2.5;2480;2.0;0;0;2480;10;420000.0
2;1.0;870;1.0;0;0;870;7;357000.0
3;2.5;2280;2.0;0;0;2280;8;364250.0
4;2.5;4070;2.0;0;0;4070;10;710000.0
4;1.5;2040;1.0;0;660;1380;7;385000.0
3;2.5;1910;2.0;0;0;1910;8;615000.0
4;2.5;3120;2.0;0;0;3120;9;444900.0
4;1.75;2120;1.0;0;1060;1060;8;710000.0
4;2.5;3270;2.0;0;0;3270;9;725000.0
4;2.75;1690;1.5;0;290;1400;7;550000.0
4;2.5;2530;2.0;0;520;2010;8;331950.0
4;1.75;3420;1.0;0;1650;1770;8;715000.0
4;4.75;3970;2.0;0;580;3390;11;2300000.0
3;3.5;2880;1.0;0;1190;1690;8;1015000.0
2;1.0;1080;1.0;0;0;1080;6;203000.0
4;1.75;1880;1.0;0;750;1130;7;284000.0
3;2.25;1460;1.0;0;0;1460;7;505000.0
3;2.0;1510;1.5;0;0;1510;8;675000.0
3;2.25;1500;2.0;0;0;1500;7;400000.0
3;2.5;2540;2.0;0;0;2540;8;489950.0
4;2.5;2200;2.0;0;0;2200;7;280000.0
3;2.5;1600;2.0;0;0;1600;7;280000.0
3;2.5;2290;2.0;0;0;2290;9;440000.0
4;2.75;2920;2.0;0;0;2920;9;730000.0
3;2.5;2090;2.0;0;0;2090;8;415000.0
2;1.0;1390;1.0;0;480;910;6;365000.0
3;2.5;1810;3.0;0;0;1810;7;579950.0
3;2.25;1810;1.0;0;570;1240;7;251700.0
4;1.0;1400;1.5;0;0;1400;6;325000.0
3;1.75;1620;2.0;0;0;1620;7;370000.0
3;1.75;1430;2.0;0;0;1430;8;520000.0
3;1.0;1200;1.0;0;0;1200;7;402000.0
3;2.25;1370;2.0;0;0;1370;7;305000.0
4;1.5;1850;1.5;0;740;1110;6;399950.0
2;1.75;1700;1.0;0;440;1260;8;895000.0
3;2.0;1760;1.0;0;0;1760;7;229000.0
4;1.75;2120;1.0;0;1060;1060;7;379400.0
3;1.75;1750;1.0;0;0;1750;7;380000.0
3;2.5;2610;2.0;0;0;2610;8;605000.0
3;1.75;1720;1.0;0;860;860;7;575000.0
5;2.75;2470;1.0;0;1220;1250;8;400000.0
4;2.0;2750;1.0;0;0;2750;8;333000.0
3;1.0;980;1.0;0;0;980;7;185000.0
4;2.5;2740;1.0;0;760;1980;8;525000.0
5;5.75;7730;2.0;0;1070;6660;12;1920000.0
2;1.0;1180;1.0;0;0;1180;6;336000.0
3;2.0;2360;2.0;0;800;1560;8;690000.0
3;1.0;980;1.0;0;0;980;7;550000.0
3;1.75;2270;1.0;0;940;1330;8;258000.0
3;2.0;2130;1.0;0;0;2130;8;880000.0
5;3.0;2520;2.0;0;510;2010;8;670000.0
4;3.5;2760;2.0;0;0;2760;9;1103990.0
5;3.0;2970;2.0;0;0;2970;9;726000.0
2;1.0;910;1.0;0;0;910;5;301000.0
3;2.5;2310;1.0;0;0;2310;8;739000.0
4;1.0;1130;1.0;0;0;1130;7;215000.0
2;2.5;1570;3.0;0;0;1570;7;208400.0
4;1.75;1800;2.0;0;0;1800;8;865000.0
2;2.5;2110;1.0;0;520;1590;8;380000.0
3;1.0;1040;1.0;0;0;1040;6;200000.0
3;1.75;1300;1.0;0;0;1300;7;198000.0
3;2.5;2250;2.0;0;0;2250;8;445838.0
3;2.0;1500;2.0;0;0;1500;8;505000.0
3;1.75;2040;1.0;0;630;1410;7;552500.0
3;2.5;2490;2.0;0;0;2490;9;634000.0
3;1.0;1060;1.0;0;0;1060;7;326250.0
4;2.5;2960;2.0;0;0;2960;9;385000.0
3;1.0;1100;1.5;0;0;1100;6;361000.0
3;2.5;3000;1.5;0;890;2110;7;666000.0
3;1.5;1140;2.0;0;0;1140;7;310000.0
4;2.5;3030;2.0;0;500;2530;9;998000.0
3;2.5;2200;2.0;0;0;2200;8;365000.0
2;2.5;2680;1.0;0;0;2680;9;775000.0
3;2.5;1794;2.0;0;0;1794;7;254950.0
4;2.25;2170;1.0;0;870;1300;8;488800.0
3;2.0;1310;1.0;0;0;1310;7;255000.0
3;2.25;1960;2.0;0;0;1960;8;605000.0
4;2.75;2170;2.0;0;0;2170;7;366000.0
4;2.75;3100;2.0;0;0;3100;8;564500.0
2;2.0;1360;2.0;0;0;1360;6;222000.0
2;2.5;980;3.0;0;0;980;8;334900.0
3;2.5;2030;2.0;0;310;1720;8;471000.0
3;2.25;998;2.0;0;200;798;7;324000.0
4;2.5;2960;2.0;0;0;2960;9;367000.0
3;1.75;1150;1.0;0;0;1150;7;464500.0
3;2.5;1360;3.0;0;50;1310;7;535000.0
2;1.0;860;1.0;0;0;860;6;235000.0
4;3.5;2350;2.0;0;680;1670;8;655000.0
4;2.5;2340;2.0;0;0;2340;9;645000.0
4;2.5;2900;2.0;0;0;2900;9;850000.0
3;1.5;1440;1.0;0;0;1440;7;456000.0
4;2.5;3310;2.0;0;0;3310;9;803100.0
5;3.0;3030;1.5;0;1100;1930;7;794500.0
4;2.5;2341;2.0;0;0;2341;9;640000.0
2;1.5;1480;1.0;0;550;930;7;509250.0
3;2.5;1680;2.0;0;560;1120;9;629950.0
4;2.5;2180;2.0;0;770;1410;7;435000.0
3;1.5;1500;1.0;0;0;1500;7;392000.0
3;3.0;2980;2.0;0;0;2980;9;670000.0
3;2.5;1570;2.5;0;330;1240;9;547000.0
4;2.25;2260;2.0;0;860;1400;8;599000.0
3;2.25;2090;1.0;0;740;1350;7;485000.0
3;3.0;1490;2.0;0;530;960;7;390000.0
3;1.75;2040;1.5;0;260;1780;7;600000.0
3;1.75;1410;1.0;0;0;1410;7;760000.0
3;2.5;1300;2.0;0;420;880;8;329950.0
3;1.5;1530;1.0;0;0;1530;7;450000.0
2;2.5;1680;3.0;0;0;1680;9;935000.0
4;1.5;1220;1.5;0;0;1220;7;483000.0
4;2.25;1920;2.0;0;0;1920;8;625000.0
5;2.0;2280;1.5;0;0;2280;6;365000.0
3;1.75;1430;2.0;0;0;1430;7;375000.0
3;1.75;1330;1.0;0;0;1330;7;183000.0
5;2.75;2870;1.0;0;1220;1650;7;646000.0
4;2.5;2105;2.0;0;0;2105;8;330000.0
3;2.5;2360;2.0;0;0;2360;7;441500.0
3;2.5;2750;2.0;0;0;2750;9;625000.0
4;2.5;1890;2.0;0;0;1890;7;388500.0
4;1.75;1500;1.0;0;300;1200;7;289950.0
3;1.0;2000;1.0;0;1000;1000;6;244000.0
3;2.0;1230;1.0;0;0;1230;7;295000.0
2;1.0;680;1.0;0;0;680;6;110700.0
5;2.5;2500;1.0;0;810;1690;8;305000.0
4;1.5;1780;1.0;0;600;1180;8;240000.0
3;1.75;1930;1.0;0;0;1930;8;795000.0
4;2.25;1890;1.5;0;540;1350;7;620000.0
4;2.5;5300;2.0;1;730;4570;10;2555000.0
5;2.25;2730;1.5;0;600;2130;8;920000.0
3;1.0;1060;1.0;0;0;1060;7;641200.0
3;1.75;1300;1.0;0;0;1300;7;385000.0
3;2.5;2242;2.0;0;0;2242;8;310000.0
3;2.25;1890;1.0;0;660;1230;7;435000.0
4;2.5;3480;1.0;0;1500;1980;9;490000.0
3;3.25;3870;2.0;0;900;2970;9;645000.0
3;1.5;1190;1.0;0;0;1190;7;332900.0
3;1.0;1580;1.5;0;0;1580;7;749000.0
4;5.5;6930;1.0;0;2620;4310;11;2525000.0
5;3.5;4150;2.0;0;0;4150;11;635000.0
2;1.75;2090;1.0;0;1000;1090;7;275000.0
5;1.75;1910;1.0;0;520;1390;8;607000.0
3;2.25;1570;1.0;0;390;1180;7;272950.0
4;2.25;1995;2.0;0;0;1995;8;266000.0
4;2.5;2820;2.0;0;0;2820;9;428900.0
3;1.75;1550;1.0;0;450;1100;7;453000.0
3;2.5;2410;2.0;0;0;2410;9;715000.0
3;1.75;1320;1.0;0;0;1320;7;313000.0
3;2.0;1530;1.0;0;0;1530;7;247500.0
3;3.5;1550;2.0;0;390;1160;8;530000.0
4;2.5;2303;2.0;0;0;2303;8;329995.0
3;2.5;1500;2.0;0;0;1500;7;295000.0
3;3.0;1520;3.0;0;0;1520;8;399000.0
3;2.75;1830;2.0;0;0;1830;8;434000.0
3;1.75;1870;1.0;0;0;1870;9;595888.0
3;1.0;1060;1.0;0;0;1060;6;160000.0
4;3.0;1984;2.0;0;0;1984;7;292000.0
3;1.5;1270;3.0;0;0;1270;8;461000.0
3;2.5;1590;2.0;0;0;1590;7;310000.0
3;1.75;1630;1.0;0;0;1630;7;431000.0
2;1.0;1190;1.0;0;360;830;6;229000.0
3;1.5;1690;1.0;0;0;1690;7;464550.0
4;3.5;3440;2.0;0;0;3440;10;1330000.0
4;2.5;1900;2.0;0;0;1900;8;535800.0
4;2.0;1730;1.0;0;670;1060;7;569000.0
4;2.75;4280;2.0;0;380;3900;9;1900000.0
3;1.75;1730;1.0;0;0;1730;9;299900.0
6;4.5;3500;2.0;0;0;3500;7;350000.0
2;1.5;830;2.0;0;0;830;7;271115.0
5;2.5;2690;1.0;0;900;1790;8;469000.0
3;2.0;1460;1.0;0;0;1460;7;225000.0
4;3.25;3600;2.0;0;290;3310;11;1415000.0
3;2.5;2040;2.0;0;0;2040;8;350000.0
3;1.75;1080;1.0;0;0;1080;7;115000.0
4;3.0;2630;2.0;0;0;2630;9;731688.0
3;1.75;1660;1.0;0;700;960;7;410000.0
3;2.0;1640;1.0;0;0;1640;7;279000.0
5;2.75;3100;2.0;0;0;3100;7;475000.0
2;1.0;580;1.0;0;0;580;5;220000.0
4;2.75;2670;2.0;0;1040;1630;8;675000.0
4;2.5;3560;1.0;0;1500;2060;8;1280600.0
3;2.5;2510;2.0;0;0;2510;8;667000.0
3;1.5;1280;2.0;0;0;1280;6;184500.0
2;1.5;1110;2.0;0;180;930;8;499000.0
3;2.5;2140;2.0;0;0;2140;8;640000.0
3;1.75;1460;1.0;0;0;1460;7;330000.0
3;2.75;3010;2.0;0;0;3010;9;785000.0
3;1.75;1770;1.0;0;500;1270;8;240000.0
4;1.75;1990;1.5;0;800;1190;7;445000.0
3;2.5;1530;2.0;0;0;1530;8;570000.0
3;1.75;1500;1.0;0;0;1500;8;529000.0
5;1.75;2040;1.0;0;1020;1020;7;561750.0
3;1.0;960;1.0;0;0;960;7;319000.0
3;2.5;2110;1.0;0;770;1340;8;604950.0
4;1.75;1740;1.0;0;470;1270;7;450000.0
4;2.5;2350;2.0;0;0;2350;8;770000.0
3;1.75;1810;1.0;0;520;1290;7;325000.0
4;2.25;2620;1.0;0;1190;1430;9;765000.0
2;1.0;910;1.0;0;0;910;6;155000.0
4;2.0;1580;1.0;0;540;1040;7;245000.0
4;2.5;2750;2.0;0;0;2750;9;763776.0
5;3.25;3160;1.0;0;970;2190;7;620000.0
3;1.75;1600;1.0;0;0;1600;8;480000.0
3;1.75;1720;1.0;0;580;1140;7;220000.0
3;2.5;2140;1.0;0;0;2140;8;799000.0
3;2.5;2100;1.0;0;0;2100;8;506000.0
2;1.0;600;1.0;0;0;600;5;110000.0
4;3.0;3140;1.0;0;1000;2140;9;946000.0
2;0.5;1180;1.0;0;590;590;6;273000.0
4;1.0;1620;1.5;0;0;1620;7;430000.0
4;2.5;2390;2.0;0;0;2390;9;360000.0
4;2.75;2660;2.0;0;0;2660;9;695000.0
3;2.5;1970;2.0;0;0;1970;8;299995.0
3;1.5;1400;1.0;0;0;1400;7;285000.0
3;1.0;760;1.0;0;0;760;5;167500.0
4;2.5;2100;2.0;0;0;2100;8;305000.0
3;2.25;1740;1.0;0;500;1240;7;305000.0
4;1.75;2420;1.0;0;540;1880;8;602000.0
3;2.25;1765;2.0;0;0;1765;7;250000.0
3;1.75;1720;1.0;0;550;1170;7;583500.0
3;2.0;1800;2.0;0;0;1800;8;539000.0
4;3.25;2330;2.0;0;0;2330;9;1300000.0
6;2.5;3596;1.0;0;1798;1798;8;580000.0
4;2.5;3220;2.0;0;0;3220;10;748000.0
3;2.0;1620;1.0;0;420;1200;7;525000.0
2;2.0;1930;1.0;0;0;1930;8;548050.0
3;2.25;1420;2.0;0;0;1420;7;410000.0
3;1.25;1230;1.5;0;0;1230;7;275000.0
5;2.75;2440;1.0;0;1200;1240;7;525000.0
4;2.5;2120;2.0;0;0;2120;7;414000.0
3;1.5;1190;1.5;0;0;1190;7;375000.0
3;1.75;1380;1.5;0;0;1380;7;550000.0
4;2.0;2030;1.0;0;0;2030;7;335000.0
3;1.75;1200;1.0;0;0;1200;7;385000.0
3;1.0;1240;1.0;0;180;1060;7;355000.0
3;1.75;1400;1.0;0;0;1400;7;235000.0
4;3.5;1800;2.0;0;0;1800;8;958000.0
4;2.5;3220;2.0;0;800;2420;9;558000.0
9;4.5;3830;2.5;0;1380;2450;7;599999.0
3;1.75;1370;2.0;0;0;1370;7;570000.0
4;2.0;2380;2.0;0;0;2380;8;855000.0
5;2.75;3740;1.0;0;1760;1980;8;595000.0
4;2.5;4150;2.0;0;0;4150;10;969990.0
4;2.5;2080;1.0;0;880;1200;7;480000.0
4;2.0;2610;1.5;0;920;1690;6;294950.0
4;2.5;2250;2.0;0;0;2250;8;476500.0
3;1.75;1780;1.0;0;360;1420;8;250000.0
3;2.0;1320;1.0;0;0;1320;7;445800.0
5;1.75;1910;2.0;0;0;1910;9;1125000.0
3;2.0;2620;1.0;0;0;2620;7;394250.0
4;2.0;1530;2.0;0;0;1530;7;231000.0
2;1.75;1270;1.5;0;0;1270;7;416000.0
3;2.5;3490;1.0;0;1720;1770;9;1620500.0
1;1.0;820;1.0;0;60;760;8;219500.0
3;1.0;1290;1.0;0;320;970;7;225000.0
3;1.5;1140;3.0;0;0;1140;8;399995.0
3;1.0;1380;1.5;0;0;1380;7;408000.0
3;2.5;1690;2.0;0;0;1690;8;277500.0
3;2.0;2410;1.5;0;0;2410;7;485000.0
3;1.0;1200;1.0;0;0;1200;7;275000.0
3;1.5;1360;3.0;0;0;1360;8;385000.0
5;4.5;10040;2.0;1;2360;7680;11;7062500.0
5;3.0;2970;1.0;0;1160;1810;8;320000.0
3;0.75;1110;1.0;0;0;1110;7;413252.0
3;2.25;2610;2.0;0;0;2610;9;675000.0
3;1.5;1960;1.0;0;940;1020;7;500000.0
3;1.0;1330;1.0;0;400;930;7;320000.0
3;2.0;1690;1.0;0;0;1690;7;459800.0
4;2.5;2570;1.0;0;860;1710;8;752000.0
3;1.5;1750;2.0;0;0;1750;8;260000.0
3;2.0;1370;1.0;0;0;1370;7;252000.0
3;1.0;1570;1.0;0;0;1570;7;330000.0
3;1.75;1910;1.0;0;620;1290;7;250000.0
4;1.75;2430;1.0;0;850;1580;8;585000.0
5;1.75;2840;2.0;0;0;2840;7;345000.0
4;2.5;3800;2.0;0;0;3800;9;894000.0
3;1.5;1200;1.0;0;0;1200;7;361000.0
4;2.0;1850;1.0;0;0;1850;7;360000.0
3;3.0;3180;2.0;0;940;2240;11;1325000.0
3;2.25;3360;2.0;0;590;2770;10;2193000.0
4;2.5;2280;2.0;0;0;2280;7;349000.0
3;1.75;1100;1.0;0;0;1100;7;224000.0
3;1.0;1240;1.0;0;0;1240;7;324950.0
3;1.0;2230;2.0;0;600;1630;8;770000.0
5;1.0;1420;1.5;0;0;1420;8;569950.0
3;2.5;1720;2.0;0;0;1720;8;540000.0
3;2.5;1310;2.0;0;130;1180;8;475000.0
3;1.0;1080;1.5;0;0;1080;7;219000.0
3;2.0;1280;2.0;0;240;1040;9;549900.0
3;1.0;1480;1.0;0;700;780;6;170000.0
4;1.75;1900;1.0;0;0;1900;7;190000.0
3;2.5;3400;2.0;0;0;3400;9;815000.0
5;3.75;3990;2.0;0;900;3090;8;740000.0
2;1.0;770;1.0;0;0;770;6;180000.0
2;1.75;1210;1.0;0;0;1210;6;456200.0
2;2.0;1410;1.5;0;0;1410;8;439900.0
2;1.0;1140;1.0;0;0;1140;7;327000.0
3;0.75;1240;1.0;0;0;1240;7;699999.0
3;1.0;1250;1.5;0;0;1250;6;219000.0
4;2.5;1940;2.0;0;0;1940;8;380000.0
3;1.5;2160;2.0;0;540;1620;8;900000.0
2;0.75;700;1.0;0;0;700;6;250000.0
4;2.5;3320;2.0;0;0;3320;10;813000.0
5;2.75;3650;2.0;0;900;2750;9;1195000.0
3;1.75;2120;1.0;0;740;1380;7;249000.0
4;2.5;1788;2.0;0;0;1788;7;294400.0
3;2.25;2390;1.0;0;410;1980;10;1185000.0
4;1.75;2010;1.5;0;0;2010;7;740000.0
2;1.75;1240;1.0;0;0;1240;7;471000.0
4;3.5;4370;1.0;0;1790;2580;10;858000.0
3;2.25;1710;1.0;0;500;1210;7;385000.0
3;2.0;1840;1.0;0;800;1040;7;750000.0
3;2.5;2280;3.0;0;390;1890;9;950000.0
3;1.0;1120;1.0;0;0;1120;7;442500.0
4;3.25;1900;2.0;0;650;1250;9;579000.0
3;2.75;1720;1.0;0;0;1720;7;340000.0
3;2.0;1670;1.0;0;0;1670;7;555565.0
4;1.0;1560;1.5;0;0;1560;6;305000.0
2;2.25;1610;2.0;0;0;1610;7;305000.0
3;2.5;3420;1.0;0;1670;1750;10;789900.0
4;2.75;3350;2.0;0;0;3350;9;700000.0
3;1.0;1170;1.0;0;300;870;7;470000.0
5;5.25;5090;2.0;0;0;5090;12;3100000.0
4;3.0;2890;1.0;0;1300;1590;7;476000.0
6;3.0;2320;1.0;0;1120;1200;7;384000.0
3;1.75;1650;1.0;0;0;1650;8;485000.0
2;1.0;990;1.0;0;0;990;7;179000.0
3;1.75;1090;1.0;0;240;850;7;680000.0
3;2.25;2420;1.0;0;1000;1420;8;1100000.0
3;1.0;1210;1.0;0;0;1210;6;465000.0
5;3.25;3160;2.0;0;0;3160;8;574950.0
3;1.0;1340;1.0;0;0;1340;5;210000.0
3;1.5;1390;2.0;0;0;1390;7;345000.0
2;1.0;810;1.0;0;0;810;6;408000.0
3;2.5;2550;2.0;0;0;2550;7;353000.0
3;1.75;1370;1.0;0;0;1370;6;225000.0
3;1.75;1970;1.0;0;550;1420;8;540000.0
3;2.5;1700;2.0;0;0;1700;8;534500.0
2;1.0;900;1.0;0;0;900;6;185000.0
5;3.5;3610;2.0;0;0;3610;7;587000.0
3;2.0;1480;1.0;0;0;1480;7;254000.0
4;1.0;1330;1.0;0;360;970;7;458450.0
3;2.5;2810;2.0;0;0;2810;8;533000.0
5;3.25;3450;2.0;0;1590;1860;9;1378600.0
3;1.0;1550;1.0;0;300;1250;7;299000.0
3;1.0;930;1.0;0;0;930;6;250000.0
4;2.5;2790;2.0;0;0;2790;8;374950.0
4;2.25;3490;1.5;0;0;3490;8;449950.0
3;2.5;1690;2.0;0;540;1150;8;404763.0
4;2.25;1960;1.0;0;740;1220;8;285000.0
4;2.5;3200;2.0;0;0;3200;8;337000.0
3;2.5;1578;2.0;0;0;1578;7;259950.0
4;1.5;1820;1.5;0;0;1820;7;229000.0
4;2.5;2740;2.0;0;0;2740;10;725000.0
4;2.5;2670;2.0;0;0;2670;9;515000.0
4;2.5;2030;2.0;0;0;2030;8;310950.0
3;2.5;1940;2.0;0;0;1940;8;555000.0
4;1.75;1400;1.0;0;0;1400;7;218500.0
2;1.75;1560;1.0;0;0;1560;8;290000.0
5;3.75;3580;2.0;0;390;3190;10;765000.0
2;2.75;2700;1.0;0;0;2700;9;850000.0
4;2.25;2400;2.0;0;0;2400;7;275000.0
3;2.5;1790;2.0;0;0;1790;8;414000.0
3;1.75;1100;1.0;0;0;1100;7;423000.0
3;2.75;1050;1.0;0;0;1050;7;473000.0
2;1.0;890;1.0;0;0;890;6;180000.0
2;1.0;930;1.0;0;0;930;6;100000.0
3;1.75;1530;1.0;0;0;1530;7;440000.0
3;2.0;1239;1.0;0;0;1239;7;253101.0
2;1.0;720;1.0;0;0;720;6;333000.0
3;1.0;1690;1.5;0;0;1690;7;240000.0
3;2.25;2120;1.0;0;0;2120;8;340000.0
4;1.75;1450;1.0;0;500;950;7;471000.0
3;2.25;1420;1.0;0;290;1130;7;270000.0
2;1.0;830;1.0;0;0;830;6;327500.0
3;2.5;2140;2.0;0;370;1770;8;666000.0
3;3.25;2580;1.5;0;820;1760;9;688888.0
2;1.0;810;1.0;0;0;810;6;450000.0
4;2.5;2850;2.0;0;0;2850;9;670000.0
3;2.25;1820;1.0;0;700;1120;7;455850.0
3;1.75;1770;2.0;0;0;1770;7;487000.0
3;2.5;1690;2.0;0;550;1140;8;430000.0
2;2.25;1260;3.0;0;0;1260;8;485000.0
3;3.5;1820;2.0;0;390;1430;8;499950.0
2;1.0;910;1.0;0;0;910;6;239900.0
3;2.5;2540;2.0;0;0;2540;9;675000.0
3;2.75;2620;1.0;0;0;2620;9;1880000.0
3;1.0;1500;1.0;0;750;750;6;270000.0
2;1.0;970;1.0;0;0;970;6;204995.0
3;2.5;1570;2.0;0;0;1570;7;315000.0
2;1.5;1750;1.5;0;310;1440;8;575000.0
3;2.0;2270;1.0;0;1000;1270;6;452000.0
3;1.0;1000;1.0;0;0;1000;6;220000.0
2;1.75;1540;1.0;0;350;1190;7;570000.0
2;1.5;1643;1.0;0;0;1643;7;324950.0
3;1.75;1170;1.0;0;0;1170;7;185000.0
2;1.0;700;1.0;0;0;700;4;152000.0
5;2.75;2620;2.0;0;0;2620;9;535000.0
4;2.5;2090;1.0;0;1000;1090;7;325000.0
4;3.0;3760;2.0;0;1290;2470;8;494500.0
5;2.75;3240;2.0;0;0;3240;10;719950.0
4;2.25;2360;2.0;0;840;1520;8;695000.0
3;2.5;1590;2.0;0;0;1590;7;299000.0
2;1.0;840;1.0;0;0;840;6;150000.0
3;1.75;1770;1.0;0;0;1770;8;229500.0
2;1.0;940;1.0;0;0;940;7;443500.0
4;3.0;2940;1.0;0;1300;1640;8;640000.0
3;2.0;1470;1.0;0;0;1470;7;395000.0
2;1.0;930;1.0;0;0;930;6;230000.0
4;2.5;2000;2.0;0;0;2000;8;459950.0
3;1.75;2190;1.0;0;0;2190;9;1565000.0
4;1.75;2330;1.5;0;820;1510;7;687500.0
3;2.25;2880;2.0;0;0;2880;10;820000.0
3;2.5;1940;1.5;0;0;1940;7;725000.0
4;3.0;3590;2.0;0;0;3590;9;515000.0
3;2.0;1470;1.0;0;0;1470;8;480000.0
1;0.75;480;1.0;0;0;480;4;145000.0
5;4.25;4610;2.0;0;0;4610;11;1169000.0
3;2.25;1650;2.0;0;0;1650;7;233703.0
4;1.0;1550;1.5;0;0;1550;7;533000.0
4;2.25;2690;2.0;0;800;1890;9;700000.0
4;1.5;1430;1.5;0;0;1430;7;575000.0
3;2.25;1990;2.0;0;0;1990;7;180000.0
3;1.75;1480;1.5;0;280;1200;7;635000.0
4;2.5;3140;2.0;0;0;3140;9;464000.0
4;2.5;1900;2.0;0;0;1900;7;360000.0
4;2.5;2910;2.0;0;0;2910;9;525000.0
3;1.0;1150;1.0;0;0;1150;6;430000.0
4;2.0;2130;1.0;0;780;1350;7;250000.0
3;2.5;1770;1.0;0;0;1770;8;289950.0
3;2.0;1520;1.0;0;380;1140;7;434900.0
3;2.25;1720;1.5;0;270;1450;7;620000.0
3;1.75;2390;1.0;0;1040;1350;8;396500.0
3;2.25;2070;1.0;0;900;1170;7;279000.0
2;1.0;940;1.0;0;0;940;6;252000.0
4;2.5;2550;2.0;0;0;2550;9;422500.0
4;3.25;4690;2.0;0;1010;3680;10;600000.0
3;2.5;1660;2.0;0;0;1660;8;285000.0
4;2.75;2640;1.5;0;0;2640;8;395000.0
3;1.75;1270;1.5;0;0;1270;7;449000.0
3;2.5;2200;2.0;0;0;2200;7;290000.0
3;2.25;1580;2.0;0;0;1580;8;500000.0
4;2.5;2000;2.0;0;0;2000;8;260000.0
5;3.5;2720;2.0;0;890;1830;9;740000.0
2;1.0;1200;1.0;0;0;1200;6;179950.0
2;1.0;770;1.0;0;0;770;7;180000.0
3;1.0;1090;1.0;0;0;1090;7;280000.0
3;1.5;1540;1.0;0;0;1540;7;380000.0
4;2.5;2880;2.0;0;0;2880;10;1260000.0
2;1.5;1940;1.0;0;970;970;7;790000.0
2;2.25;1290;2.0;0;0;1290;7;315000.0
3;1.0;1700;1.5;0;0;1700;7;681000.0
4;3.5;3190;2.0;0;1030;2160;10;1340000.0
6;2.5;2270;1.0;0;800;1470;7;435000.0
4;2.5;4600;2.0;0;0;4600;10;800000.0
3;2.5;3680;1.0;0;1290;2390;10;770000.0
3;1.75;2200;1.0;0;700;1500;8;689000.0
4;2.25;2200;1.0;0;910;1290;7;423000.0
4;2.5;2717;2.0;0;0;2717;8;338500.0
3;1.75;1510;1.0;0;0;1510;7;310650.0
3;2.5;1639;2.0;0;160;1479;8;450000.0
3;2.25;1950;1.0;0;0;1950;8;408000.0
4;2.5;2350;2.0;0;0;2350;8;649950.0
5;3.0;1880;1.0;0;780;1100;7;310000.0
3;1.5;720;1.0;0;0;720;5;295000.0
5;3.25;3840;3.0;0;1090;2750;10;1462500.0
4;1.75;1960;1.0;0;620;1340;7;372000.0
4;1.5;1550;1.0;0;550;1000;7;418000.0
2;1.0;1430;1.5;0;0;1430;7;455000.0
3;3.5;3030;2.0;0;0;3030;8;700000.0
3;1.0;1380;1.5;0;0;1380;6;189000.0
4;2.5;2110;2.0;0;0;2110;8;772000.0
4;2.75;2140;2.0;0;0;2140;7;304400.0
2;1.75;1480;1.0;0;740;740;6;409000.0
4;1.5;1420;1.5;0;0;1420;8;679000.0
3;2.25;2180;1.0;0;430;1750;7;455000.0
3;1.0;910;1.0;0;0;910;7;290000.0
4;2.0;2380;1.5;0;910;1470;6;455000.0
5;3.0;2440;1.0;0;990;1450;9;495000.0
4;1.5;1420;1.0;0;480;940;7;205000.0
3;2.5;1830;2.0;0;0;1830;8;298900.0
2;1.0;700;1.0;0;0;700;5;209995.0
4;2.75;2050;1.0;0;750;1300;7;584999.0
4;1.75;2510;1.0;0;830;1680;8;595000.0
6;2.75;2840;1.0;0;1420;1420;8;665000.0
5;1.75;2180;1.0;0;1040;1140;7;275000.0
3;1.75;2080;1.0;0;1040;1040;6;280000.0
3;1.75;1900;1.0;0;0;1900;8;335000.0
4;2.5;2750;2.0;0;0;2750;9;627000.0
3;1.75;1350;1.0;0;300;1050;7;337500.0
3;2.25;1440;2.0;0;0;1440;7;432250.0
4;2.5;2190;2.0;0;0;2190;8;349000.0
3;2.0;1560;1.0;0;0;1560;7;226500.0
3;1.75;2090;1.0;0;760;1330;8;489500.0
6;4.25;6980;3.0;0;1650;5330;12;3100000.0
3;1.75;1590;1.0;0;500;1090;7;274000.0
1;2.0;1150;1.0;0;0;1150;7;227000.0
3;1.5;1540;1.0;0;0;1540;7;270000.0
3;1.75;2000;1.0;0;920;1080;7;519000.0
3;2.5;1920;2.0;0;0;1920;8;475000.0
4;1.75;2450;1.0;0;820;1630;9;760000.0
3;2.25;1480;1.0;0;260;1220;7;439000.0
4;1.75;1940;1.0;0;910;1030;7;505000.0
4;3.25;3470;1.0;0;1200;2270;11;1320000.0
3;2.25;1430;3.0;0;0;1430;8;407000.0
3;1.0;900;1.0;0;200;700;5;355000.0
3;2.5;1760;3.0;0;120;1640;8;608000.0
3;2.0;1540;1.0;0;0;1540;7;275000.0
3;1.0;1520;1.0;0;530;990;7;310000.0
3;2.0;1400;2.0;0;0;1400;8;410000.0
4;1.75;1690;1.0;0;800;890;6;400375.0
3;1.0;1250;1.0;0;0;1250;7;305000.0
3;2.0;2030;1.0;0;810;1220;7;225000.0
2;2.25;1230;2.0;0;70;1160;7;325000.0
4;2.25;2060;1.0;0;760;1300;7;340000.0
3;2.25;1850;1.0;0;700;1150;7;461000.0
3;1.75;2280;1.0;0;0;2280;8;413000.0
4;2.5;2440;2.0;0;740;1700;8;820000.0
2;1.5;1556;1.0;0;0;1556;7;221700.0
3;1.0;1600;1.0;0;800;800;6;364500.0
3;2.0;1920;1.0;0;0;1920;8;443500.0
3;2.5;1560;2.0;0;0;1560;7;296000.0
2;1.0;980;1.5;0;0;980;7;550000.0
4;2.5;3930;2.0;0;0;3930;11;1093000.0
5;3.0;3490;2.0;0;0;3490;9;715000.0
3;1.0;1180;1.0;0;0;1180;7;355000.0
2;1.5;1010;2.0;0;0;1010;7;370000.0
3;1.75;1640;1.0;0;300;1340;8;471000.0
4;2.0;2460;1.0;0;1230;1230;7;247500.0
2;1.0;770;1.0;0;0;770;7;497000.0
3;1.75;1400;1.0;0;0;1400;7;269950.0
3;1.75;2930;2.0;0;490;2440;8;549950.0
3;1.5;1410;1.0;0;630;780;7;215000.0
5;3.0;2750;1.5;0;1000;1750;7;525000.0
2;1.0;900;1.0;0;0;900;7;496000.0
4;2.75;2620;2.0;0;0;2620;9;672500.0
3;2.5;1970;2.0;0;0;1970;7;419000.0
2;2.0;1260;1.0;0;240;1020;7;230000.0
3;2.25;1850;1.0;0;550;1300;7;469500.0
2;1.0;1450;1.0;0;0;1450;7;822500.0
4;2.5;3350;1.0;0;1590;1760;10;1200000.0
4;2.5;1890;2.0;0;0;1890;8;355000.0
3;2.5;2200;2.0;0;0;2200;9;424000.0
3;2.0;1370;1.0;0;0;1370;7;354800.0
3;1.75;1590;1.5;0;0;1590;6;249000.0
5;1.75;2980;1.0;0;750;2230;9;575000.0
3;2.75;1690;1.0;0;510;1180;7;410000.0
4;2.5;3510;2.0;0;0;3510;10;900000.0
4;2.5;3570;2.0;0;0;3570;9;928990.0
2;1.0;810;1.0;0;0;810;6;194900.0
2;1.0;950;1.0;0;0;950;6;520000.0
5;1.75;2440;1.5;0;700;1740;8;765000.0
3;1.0;1180;1.5;0;0;1180;7;490000.0
4;3.0;2660;1.5;0;840;1820;8;1234000.0
4;1.75;1840;1.0;0;630;1210;7;274900.0
3;1.0;1510;1.5;0;0;1510;6;195000.0
4;2.5;2230;2.0;0;0;2230;8;305000.0
2;1.0;920;1.0;0;0;920;6;156000.0
5;2.75;2300;1.0;0;900;1400;7;294000.0
4;2.75;3030;2.0;0;0;3030;8;525000.0
3;2.5;1880;2.0;0;0;1880;7;284000.0
3;1.0;1300;1.0;0;0;1300;6;225000.0
4;1.5;1450;1.0;0;0;1450;6;175409.0
3;1.5;1500;1.0;0;200;1300;8;436000.0
3;2.5;2450;2.0;0;0;2450;9;480000.0
4;1.75;1670;1.0;0;0;1670;7;456000.0
2;1.0;950;1.0;0;0;950;5;250000.0
2;1.5;1030;3.0;0;0;1030;8;326000.0
4;2.75;2950;2.0;0;1140;1810;7;1045000.0
4;2.25;1780;2.0;0;0;1780;8;395000.0
3;2.0;1108;3.0;0;0;1108;7;369500.0
4;2.5;2770;1.0;0;830;1940;7;355000.0
3;3.0;2960;2.0;0;520;2440;10;1340000.0
4;2.0;1840;1.5;0;760;1080;6;433000.0
2;2.5;1900;2.0;0;0;1900;8;541500.0
2;1.75;1200;1.0;0;400;800;7;420000.0
3;2.25;2020;2.0;0;340;1680;8;430000.0
4;2.5;2050;2.0;0;0;2050;7;331500.0
3;2.0;2270;1.0;0;0;2270;9;815000.0
3;1.75;1240;1.0;0;0;1240;6;192000.0
4;1.75;1740;1.0;0;0;1740;8;560000.0
2;1.0;960;1.0;0;0;960;7;420000.0
5;3.5;4280;2.0;0;0;4280;10;1138990.0
4;3.25;3450;2.0;0;1000;2450;8;850000.0
4;2.25;2270;1.0;0;1120;1150;7;500000.0
3;1.75;2620;1.0;0;1300;1320;8;525000.0
3;1.5;1300;1.0;0;0;1300;7;425000.0
3;1.5;2790;1.0;0;1090;1700;8;560000.0
4;3.5;3440;2.0;0;880;2560;11;1305000.0
4;2.5;2150;2.0;0;0;2150;8;639000.0
4;1.75;1970;1.0;0;430;1540;8;385000.0
4;3.0;2570;2.0;0;0;2570;7;500000.0
1;0.75;380;1.0;0;0;380;5;245000.0
3;2.0;1540;1.0;0;0;1540;6;229000.0
3;1.75;1550;1.0;0;500;1050;7;530000.0
5;2.0;1760;1.0;0;200;1560;8;480000.0
3;1.75;2110;1.0;0;830;1280;8;540000.0
3;1.5;1020;1.0;0;0;1020;6;165000.0
4;1.5;1780;2.0;0;700;1080;6;200000.0
2;2.0;1470;1.5;0;0;1470;7;239000.0
3;2.5;2350;2.0;0;0;2350;7;410000.0
2;1.0;840;1.0;0;0;840;6;190000.0
4;2.5;2340;2.0;0;0;2340;8;360000.0
3;1.75;1560;1.5;0;0;1560;7;422500.0
4;2.5;2600;2.0;0;0;2600;8;359900.0
4;2.5;3300;2.0;0;0;3300;8;760000.0
3;1.5;1940;2.0;0;200;1740;8;815000.0
5;2.5;2910;1.0;0;1220;1690;7;530000.0
3;1.75;2000;1.0;0;0;2000;6;374000.0
3;2.25;1760;3.0;0;0;1760;9;643950.0
4;2.25;2200;1.0;0;980;1220;8;610000.0
4;2.75;1640;1.0;0;640;1000;7;320000.0
3;3.5;3200;2.0;0;0;3200;10;699000.0
4;2.25;2270;1.0;0;930;1340;8;735000.0
3;2.25;1430;2.0;0;0;1430;8;439000.0
2;1.5;960;1.0;0;0;960;7;525000.0
2;2.25;1660;2.0;0;0;1660;7;235000.0
4;2.0;2270;2.0;0;0;2270;8;724950.0
4;3.0;4180;2.0;0;0;4180;11;550000.0
1;0.75;930;1.0;0;0;930;6;190000.0
3;1.75;1620;1.0;0;790;830;7;500000.0
4;2.75;2490;2.0;0;1000;1490;9;740000.0
4;2.5;2050;2.0;0;0;2050;8;540000.0
4;1.75;2500;1.0;0;1000;1500;8;965800.0
4;2.5;2280;2.0;0;0;2280;8;322000.0
4;1.75;2170;1.0;0;800;1370;7;588000.0
4;2.0;1350;3.0;0;0;1350;7;304500.0
4;3.25;2290;2.0;0;0;2290;9;359950.0
4;2.0;1580;1.0;0;0;1580;7;410000.0
4;1.0;1860;1.5;0;0;1860;7;427000.0
4;2.5;1740;1.0;0;0;1740;7;339000.0
5;1.5;1980;1.5;0;0;1980;7;215000.0
5;2.75;2660;1.0;0;1190;1470;8;1100000.0
4;2.25;2240;2.0;0;0;2240;10;975000.0
2;2.25;1240;2.0;0;90;1150;7;331000.0
3;2.0;2130;2.0;0;0;2130;7;645000.0
3;1.5;1540;1.0;0;0;1540;7;480000.0
2;2.0;1680;1.0;0;0;1680;8;575000.0
3;2.0;1660;1.0;0;830;830;7;405000.0
4;3.5;3920;2.0;0;0;3920;9;889000.0
3;2.5;2830;2.0;0;0;2830;9;551000.0
4;3.25;3780;1.0;0;1540;2240;11;1175000.0
3;1.0;1160;1.0;0;0;1160;7;317000.0
2;1.75;1660;2.0;0;0;1660;7;335000.0
4;2.5;2340;2.0;0;0;2340;7;465950.0
4;2.0;1350;3.0;0;0;1350;7;288790.0
4;4.25;4890;2.0;0;1800;3090;11;2400000.0
4;5.25;6500;2.0;0;1320;5180;11;2458000.0
3;1.0;2090;1.0;0;890;1200;8;478500.0
3;2.5;1880;2.0;0;0;1880;7;261950.0
3;2.5;2370;2.0;0;0;2370;8;351999.0
4;1.5;1540;2.0;0;0;1540;7;260000.0
4;2.5;1910;1.0;0;0;1910;8;458400.0
3;1.0;1790;1.5;0;700;1090;7;350000.0
4;2.75;3110;2.0;0;0;3110;9;799990.0
4;2.25;2620;1.0;0;1070;1550;7;360000.0
4;1.0;1530;1.5;0;0;1530;7;583500.0
3;2.5;1780;2.0;0;0;1780;7;270000.0
4;2.5;3340;2.0;0;870;2470;9;870000.0
2;1.0;830;1.0;0;0;830;6;325000.0
2;1.0;1280;1.0;0;640;640;6;340000.0
4;2.5;3250;1.0;0;0;3250;9;293000.0
3;1.75;1620;1.0;0;640;980;7;532500.0
2;1.5;1760;1.0;0;0;1760;7;500000.0
3;2.0;1390;1.5;0;0;1390;7;550000.0
3;1.5;1450;1.0;0;0;1450;7;419900.0
3;1.0;1300;1.0;0;0;1300;6;195000.0
2;1.0;720;1.0;0;0;720;6;184500.0
4;2.75;3040;2.0;0;720;2320;9;640000.0
3;2.0;2360;1.0;0;180;2180;8;709000.0
3;1.75;1340;1.0;0;0;1340;7;255000.0
2;1.0;850;1.0;0;0;850;6;280000.0
5;3.25;5600;2.0;0;2160;3440;10;1089000.0
4;2.25;2190;2.0;0;0;2190;8;294000.0
3;1.0;990;1.0;0;0;990;7;269950.0
4;4.0;4810;2.0;0;0;4810;11;3204000.0
4;1.0;1790;1.0;0;530;1260;7;401500.0
3;1.75;1920;1.0;0;660;1260;8;605000.0
2;1.0;760;1.0;0;0;760;6;162500.0
5;2.25;2960;1.0;0;1410;1550;8;1050000.0
3;1.0;1480;2.5;0;0;1480;6;455000.0
5;2.25;2320;1.0;0;1050;1270;7;260000.0
4;2.5;2410;2.0;0;0;2410;8;440000.0
5;3.25;4100;2.0;0;0;4100;10;890000.0
4;2.25;2110;2.0;0;0;2110;8;565000.0
4;2.5;1940;1.0;0;750;1190;8;425000.0
3;1.5;1280;1.0;0;0;1280;7;405000.0
2;2.5;2300;1.0;0;0;2300;8;705000.0
4;2.25;2000;1.0;0;650;1350;7;330000.0
3;2.5;1780;2.0;0;250;1530;8;443000.0
2;2.0;1040;1.0;0;0;1040;6;325000.0
4;2.5;2560;2.0;0;0;2560;7;600000.0
3;1.0;1730;1.0;0;700;1030;7;292000.0
3;1.75;1420;1.0;0;440;980;7;240000.0
3;1.0;1580;2.0;0;0;1580;8;690000.0
2;2.5;1278;2.0;0;276;1002;7;358000.0
3;2.5;1800;2.0;0;0;1800;7;285000.0
5;2.75;2930;2.0;0;0;2930;9;257000.0
4;2.0;1770;1.0;0;0;1770;6;355000.0
1;1.0;610;1.0;0;0;610;5;314200.0
3;2.25;1720;1.0;0;400;1320;8;274500.0
4;2.5;2220;2.0;0;0;2220;7;405000.0
3;3.0;1390;2.0;0;250;1140;7;275000.0
4;3.0;1900;2.0;0;0;1900;7;459000.0
3;1.0;890;1.0;0;0;890;7;328000.0
4;3.0;1990;2.0;0;0;1990;7;273000.0
3;1.75;1660;1.5;0;0;1660;7;350000.0
3;1.5;1990;1.5;1;0;1990;7;625000.0
5;2.75;3030;2.0;0;0;3030;9;819995.0
5;1.75;2330;1.5;0;250;2080;8;825000.0
4;1.75;1660;1.0;0;700;960;7;282000.0
4;2.5;2701;2.0;0;0;2701;9;399895.0
3;3.5;1480;2.0;0;180;1300;7;216650.0
3;1.75;1660;1.0;0;700;960;7;530000.0
4;2.5;2100;2.0;0;0;2100;8;333000.0
5;2.5;2820;1.0;0;1410;1410;7;318000.0
2;1.0;1010;1.0;0;0;1010;6;215000.0
4;2.5;2200;1.0;0;870;1330;7;535000.0
5;2.5;2100;1.0;0;0;2100;8;375000.0
3;3.0;1760;2.0;0;360;1400;7;605000.0
5;3.0;2980;1.0;0;1300;1680;7;595000.0
5;4.25;3970;2.0;0;1110;2860;9;811500.0
3;2.5;3200;1.5;0;1100;2100;8;605000.0
3;1.75;2300;1.0;0;1150;1150;7;325000.0
2;1.0;1070;1.0;0;0;1070;6;510000.0
2;1.0;930;1.0;0;0;930;6;226950.0
3;2.0;1810;1.0;0;800;1010;7;550000.0
2;1.0;1460;1.0;0;200;1260;7;312000.0
2;1.0;710;1.0;0;0;710;5;190000.0
3;3.25;1470;3.0;0;0;1470;8;615000.0
4;2.5;3670;2.0;0;0;3670;10;885250.0
2;2.0;1350;1.0;0;0;1350;8;428000.0
3;1.5;1420;1.0;0;0;1420;6;202000.0
4;2.75;3230;2.0;0;0;3230;8;409000.0
3;2.0;1750;1.0;0;800;950;7;477000.0
3;1.0;1450;1.0;0;0;1450;6;357500.0
5;1.75;1970;1.0;0;800;1170;7;255000.0
3;2.0;1880;1.0;0;840;1040;8;710000.0
5;2.75;3260;1.0;0;1630;1630;8;681500.0
3;2.5;2280;2.0;0;0;2280;8;470000.0
4;1.75;1800;1.5;0;0;1800;6;385000.0
3;2.0;1451;1.0;0;0;1451;7;300000.0
4;2.5;1620;2.0;0;0;1620;7;365000.0
6;2.25;2770;1.5;0;650;2120;8;685000.0
3;1.75;2430;1.0;0;810;1620;7;710000.0
4;2.75;3550;1.0;0;1450;2100;8;469000.0
2;2.25;1540;3.0;0;0;1540;9;640000.0
3;2.5;1480;2.0;0;0;1480;7;269950.0
5;1.5;2550;1.0;0;990;1560;7;369000.0
4;2.5;1980;2.0;0;0;1980;8;307550.0
3;1.5;1400;1.0;0;0;1400;6;275000.0
3;2.0;1340;3.0;0;0;1340;8;376000.0
5;1.75;2360;1.5;0;300;2060;7;302000.0
3;2.5;2470;2.0;0;0;2470;7;445000.0
3;2.25;2070;1.0;0;380;1690;8;300000.0
3;2.5;2670;2.0;0;0;2670;9;605000.0
2;2.25;1550;2.0;0;0;1550;8;320000.0
4;2.75;2700;1.0;0;0;2700;9;357000.0
5;1.75;2020;1.0;0;900;1120;8;640000.0
3;2.25;1640;2.0;0;0;1640;8;350000.0
4;3.5;2730;2.0;0;330;2400;8;769900.0
5;2.5;2140;1.0;0;810;1330;7;270000.0
3;2.0;2090;1.5;0;600;1490;8;860000.0
5;3.5;2440;2.0;0;0;2440;7;519950.0
5;4.0;3870;2.0;0;0;3870;10;1299890.0
4;2.5;3170;3.0;0;0;3170;8;820000.0
4;2.75;2460;2.0;0;0;2460;9;579950.0
4;2.5;2360;2.0;0;0;2360;8;542126.0
4;2.5;2990;2.0;0;0;2990;8;675000.0
3;1.75;1850;1.0;0;530;1320;8;218000.0
3;2.5;2390;1.0;0;550;1840;8;339950.0
4;2.5;2040;2.0;0;0;2040;8;545000.0
2;1.5;1840;1.0;0;500;1340;8;720000.0
3;1.0;1440;1.5;0;0;1440;7;370000.0
3;2.0;2580;1.5;0;0;2580;9;481000.0
3;3.25;3780;1.0;0;1130;2650;11;1153000.0
4;2.75;3650;2.0;0;1120;2530;9;1210000.0
2;1.0;1240;1.5;0;0;1240;6;319950.0
2;1.0;830;1.0;0;0;830;6;225000.0
4;1.5;1250;1.0;0;290;960;7;330000.0
3;1.0;1290;1.0;0;140;1150;7;450000.0
2;1.75;1910;1.0;0;0;1910;9;435000.0
4;3.5;2770;2.0;0;0;2770;8;550000.0
2;1.0;1070;1.0;0;0;1070;6;299000.0
2;1.0;1470;1.5;0;0;1470;4;230000.0
4;4.5;5420;1.0;0;1530;3890;11;1225000.0
3;1.5;1090;1.0;0;0;1090;7;415000.0
3;2.0;2060;1.0;0;940;1120;8;605000.0
4;2.75;1920;1.0;0;910;1010;8;353000.0
3;2.5;3430;2.0;0;0;3430;10;2205000.0
3;2.25;2230;1.0;0;720;1510;8;491500.0
4;2.5;2780;1.0;0;0;2780;9;674250.0
2;1.0;960;1.0;0;0;960;7;500000.0
5;2.75;3130;1.0;0;1550;1580;8;302300.0
4;2.5;2070;2.0;0;0;2070;8;272000.0
2;1.75;1980;2.0;0;700;1280;7;428000.0
4;2.5;2160;2.0;0;0;2160;7;312500.0
3;1.75;1600;1.0;0;0;1600;7;510000.0
1;1.0;970;1.0;0;400;570;5;215000.0
3;2.5;2810;1.0;0;1060;1750;9;479950.0
3;2.75;3580;2.0;0;1370;2210;10;600000.0
3;2.5;1960;2.0;0;290;1670;7;300000.0
4;2.5;2570;2.0;0;0;2570;7;360000.0
4;2.75;3130;2.0;0;0;3130;10;840000.0
3;2.0;1840;1.0;0;0;1840;6;521000.0
4;1.5;2230;1.5;0;900;1330;7;590000.0
4;2.75;1960;1.0;0;960;1000;7;575000.0
3;1.5;2440;1.0;0;0;2440;7;550000.0
3;2.5;2090;2.0;0;0;2090;8;299500.0
3;1.75;1740;1.0;0;240;1500;8;827235.0
3;2.0;2005;1.0;0;400;1605;7;491000.0
2;1.5;930;1.0;0;100;830;7;550500.0
2;1.0;770;1.0;0;0;770;5;413500.0
5;2.5;2406;2.0;0;0;2406;8;270500.0
4;2.5;2683;2.0;0;0;2683;9;822000.0
3;1.0;1040;1.0;0;0;1040;7;324950.0
3;3.25;1710;2.0;0;350;1360;8;445000.0
4;1.75;1710;1.0;0;0;1710;8;430000.0
2;0.75;850;1.0;0;300;550;6;360000.0
5;2.75;2510;1.0;0;910;1600;7;569950.0
3;2.5;1770;2.0;0;0;1770;7;375000.0
3;1.5;2020;1.0;0;830;1190;6;465000.0
5;1.0;1120;1.5;0;0;1120;7;340000.0
4;4.5;5550;2.0;0;1670;3880;9;1650000.0
2;2.0;1200;1.0;0;0;1200;8;408000.0
3;2.5;1230;2.0;0;150;1080;8;399950.0
3;3.0;3110;1.0;0;1520;1590;10;1500000.0
3;1.5;1280;1.0;0;0;1280;7;342450.0
4;1.5;2480;1.0;0;1100;1380;7;650000.0
2;1.5;1290;1.0;0;240;1050;7;653000.0
3;3.5;3190;2.0;0;630;2560;10;795000.0
5;2.25;3650;1.0;0;1800;1850;10;1085000.0
4;2.5;2420;1.0;0;1500;920;8;675000.0
2;1.0;1095;1.5;0;0;1095;7;302282.0
5;2.75;1690;1.0;0;720;970;7;399990.0
3;2.25;3020;2.0;0;0;3020;9;755000.0
3;1.75;1510;1.0;0;650;860;7;624000.0
4;4.0;4360;2.0;0;0;4360;10;1980000.0
3;1.75;1750;1.0;0;280;1470;7;499000.0
3;2.5;1970;2.0;0;0;1970;8;535000.0
5;2.75;2940;2.0;0;180;2760;8;837000.0
3;2.25;3290;2.0;0;560;2730;9;1482500.0
3;1.75;1810;1.0;0;0;1810;7;340500.0
3;1.0;970;1.0;0;0;970;6;219900.0
3;2.25;1420;2.0;0;0;1420;7;275000.0
3;3.0;2900;2.0;0;0;2900;10;799950.0
3;3.25;1760;3.0;0;0;1760;8;469950.0
2;0.75;720;1.0;0;0;720;4;151000.0
2;1.0;1000;1.0;0;0;1000;6;265000.0
2;2.5;1611;2.0;0;0;1611;10;850000.0
4;2.75;2950;2.0;0;0;2950;9;600000.0
5;3.0;3730;1.5;0;1570;2160;7;979700.0
3;2.5;1720;2.0;0;0;1720;8;383000.0
3;1.5;1390;2.0;0;0;1390;7;175003.0
5;4.0;2900;2.0;0;950;1950;7;312000.0
5;1.5;1720;1.5;0;0;1720;8;775000.0
3;2.25;2070;1.0;0;720;1350;7;329950.0
2;1.75;1060;2.0;0;100;960;7;352750.0
4;3.5;5360;1.0;0;2090;3270;9;700000.0
4;2.5;2790;2.0;0;0;2790;9;695000.0
4;3.0;3710;2.0;0;950;2760;10;2537000.0
4;2.5;2050;2.0;0;0;2050;8;639888.0
4;2.25;2160;1.0;0;800;1360;8;260000.0
3;2.0;1400;1.0;0;0;1400;7;253400.0
4;2.5;2510;2.0;0;0;2510;7;410000.0
4;2.5;2430;2.0;0;0;2430;8;305000.0
4;2.5;1580;2.0;0;0;1580;7;291000.0
2;2.0;1170;1.5;0;0;1170;8;613000.0
3;2.25;2400;1.5;0;960;1440;7;575000.0
3;4.5;3970;2.0;0;710;3260;10;1450000.0
3;1.75;1840;1.0;0;800;1040;7;411715.0
3;1.0;1960;1.0;0;700;1260;7;375000.0
3;3.0;2500;2.0;0;0;2500;8;364900.0
5;2.5;3020;1.0;0;1040;1980;9;975000.0
3;1.5;1950;1.0;0;940;1010;7;275000.0
3;2.25;1550;2.0;0;0;1550;8;266000.0
6;1.5;1930;1.0;0;900;1030;7;326000.0
3;2.5;2020;3.0;0;0;2020;8;720000.0
4;1.75;1820;1.0;0;740;1080;7;264000.0
3;1.75;1450;1.0;0;400;1050;7;300000.0
3;2.0;2190;1.0;0;0;2190;7;464950.0
2;1.5;1010;2.0;0;0;1010;7;306888.0
2;1.0;1290;1.0;0;0;1290;6;970000.0
2;1.0;790;1.0;0;0;790;6;110000.0
6;4.5;3810;1.0;0;0;3810;10;2005000.0
3;2.25;2590;2.0;0;0;2590;8;538250.0
4;2.75;2660;1.0;0;730;1930;8;1444000.0
3;2.5;2655;2.0;0;0;2655;8;409950.0
4;2.25;2600;1.0;0;1000;1600;7;270000.0
3;1.5;1510;1.0;0;400;1110;7;202500.0
2;2.0;1030;1.0;0;0;1030;6;212500.0
2;1.0;2540;1.0;0;1220;1320;8;580000.0
3;1.0;1980;1.0;0;950;1030;7;233000.0
4;2.75;2420;1.0;0;750;1670;7;665000.0
4;1.0;2410;1.0;0;900;1510;7;325000.0
3;1.0;1020;1.0;0;0;1020;6;242500.0
4;2.5;2658;2.0;0;0;2658;9;411605.0
3;2.25;2160;2.0;0;0;2160;8;402500.0
2;1.0;980;1.0;0;200;780;7;365000.0
3;1.5;1440;1.0;0;0;1440;8;330000.0
3;2.5;2480;2.0;0;0;2480;9;420000.0
4;2.5;2070;2.0;0;0;2070;7;343000.0
3;2.5;2040;2.0;0;0;2040;8;619000.0
3;1.75;1340;2.0;0;0;1340;7;635000.0
2;2.25;1290;3.0;0;0;1290;8;481000.0
3;2.5;2080;2.0;0;0;2080;8;448500.0
3;2.5;2170;2.0;0;0;2170;9;389950.0
3;2.25;1640;1.0;0;400;1240;7;415000.0
3;3.5;3110;1.0;0;0;3110;10;2260000.0
6;4.5;5480;2.0;0;1050;4430;9;2400000.0
4;1.75;2410;2.0;0;350;2060;8;550000.0
1;1.0;650;1.0;0;0;650;5;129000.0
2;1.75;1960;1.0;0;980;980;7;478000.0
4;2.5;2680;2.0;0;0;2680;9;419625.0
5;1.0;1880;1.5;0;520;1360;6;340000.0
3;3.25;2200;2.0;0;460;1740;8;605000.0
2;2.0;1780;1.5;0;800;980;7;691000.0
3;1.0;1980;1.0;0;860;1120;6;342000.0
4;2.25;2150;2.0;0;0;2150;8;573000.0
4;2.5;3550;2.0;0;0;3550;9;920000.0
3;2.0;1720;1.5;0;660;1060;8;935000.0
2;1.0;900;1.0;0;0;900;6;205000.0
4;1.5;1690;1.0;0;400;1290;7;420000.0
3;1.5;1330;1.0;0;0;1330;7;374500.0
3;1.75;1070;1.0;0;0;1070;7;361500.0
4;3.5;3920;2.0;0;0;3920;10;825000.0
4;2.5;3220;2.0;0;0;3220;10;710000.0
4;2.5;2850;2.0;0;0;2850;9;895000.0
2;2.25;1240;2.0;0;90;1150;7;315000.0
2;1.0;1120;1.5;0;0;1120;6;435000.0
3;2.5;2540;1.0;0;1250;1290;8;374950.0
3;1.75;1460;1.0;0;0;1460;8;601500.0
3;1.0;1110;1.0;0;0;1110;7;369950.0
2;1.0;840;1.0;0;0;840;7;315000.0
4;3.0;3260;2.0;0;960;2300;9;1280000.0
3;2.25;1590;1.0;0;420;1170;7;278000.0
4;2.25;1900;1.0;0;500;1400;7;290000.0
4;2.5;3480;2.0;0;0;3480;11;810000.0
2;1.0;1430;1.5;0;200;1230;6;425000.0
3;2.0;1640;1.0;0;550;1090;7;455000.0
3;1.5;1250;1.0;0;0;1250;7;452000.0
4;2.75;2950;1.0;0;830;2120;8;402000.0
3;1.75;1380;1.0;0;500;880;7;365000.0
3;1.0;960;1.0;0;0;960;7;179950.0
4;2.0;1540;1.0;0;500;1040;7;215000.0
5;3.0;3800;1.5;0;0;3800;9;549900.0
4;2.5;1910;2.0;0;0;1910;8;369950.0
3;3.0;1880;2.0;0;360;1520;8;630000.0
3;1.0;1450;1.0;0;400;1050;6;274950.0
3;1.75;1940;1.0;0;500;1440;8;685000.0
2;1.0;1170;1.0;0;140;1030;7;425000.0
2;2.0;1390;2.0;0;0;1390;7;186950.0
4;2.0;2990;1.0;0;0;2990;8;510000.0
4;1.75;1940;1.0;0;220;1720;7;274000.0
4;3.5;4640;2.0;0;0;4640;10;1267500.0
3;1.75;1070;1.0;0;0;1070;7;542000.0
3;1.0;1030;1.0;0;0;1030;7;427200.0
3;1.5;1280;1.0;0;0;1280;7;395000.0
3;2.25;2880;1.0;0;1170;1710;8;499950.0
4;3.25;3310;2.0;0;930;2380;9;429900.0
3;1.0;990;1.0;0;0;990;7;250000.0
3;2.0;1930;1.0;0;0;1930;7;390000.0
2;1.75;1180;1.0;0;0;1180;8;311000.0
4;1.75;1400;1.5;0;0;1400;7;242025.0
4;2.25;2510;2.0;0;0;2510;8;799000.0
3;1.0;940;1.0;0;0;940;6;370000.0
2;1.0;1020;1.0;0;0;1020;7;303000.0
3;2.5;1690;2.0;0;0;1690;7;449000.0
4;2.25;2550;1.0;0;970;1580;8;560000.0
4;2.5;3650;2.0;0;0;3650;9;835000.0
4;2.25;1920;2.0;0;0;1920;7;325000.0
2;2.5;2560;2.0;0;870;1690;8;780000.0
3;1.75;1230;1.0;0;0;1230;7;385000.0
5;2.5;2570;1.0;0;1270;1300;7;275000.0
4;2.5;2060;2.0;0;0;2060;8;543000.0
4;2.5;3510;2.0;0;0;3510;10;915000.0
4;2.5;1904;2.0;0;0;1904;7;365000.0
4;2.5;2420;2.0;0;0;2420;9;771000.0
3;2.75;2200;1.0;0;630;1570;8;375000.0
5;3.0;2400;2.0;0;0;2400;8;745000.0
3;2.5;1740;3.0;0;0;1740;8;545000.0
1;1.0;750;1.0;0;0;750;6;250000.0
5;3.5;3990;2.0;0;1170;2820;9;650000.0
4;2.25;2640;2.0;0;560;2080;7;1545000.0
2;1.5;1590;1.0;0;670;920;7;490000.0
3;2.25;2080;1.5;0;530;1550;7;267500.0
2;1.0;1110;1.0;0;100;1010;7;585000.0
4;3.25;3640;2.0;0;1680;1960;9;1265000.0
3;2.0;2180;1.5;0;500;1680;8;555000.0
4;2.0;1710;1.5;0;0;1710;7;211000.0
4;3.5;3770;2.0;0;0;3770;10;1020000.0
3;2.5;1870;2.0;0;0;1870;8;575000.0
4;2.25;3290;1.5;0;0;3290;10;947500.0
4;3.75;3160;2.5;0;0;3160;10;1381000.0
2;1.0;740;1.0;0;0;740;6;178500.0
4;2.5;1950;2.0;0;0;1950;7;315000.0
2;1.0;1200;1.0;0;0;1200;6;232000.0
3;3.5;2500;2.0;0;0;2500;8;538500.0
3;1.75;2660;1.0;0;1330;1330;8;615000.0
3;1.0;1330;1.5;0;0;1330;6;310000.0
4;2.5;2090;2.0;0;0;2090;8;455000.0
3;2.0;1240;1.0;0;620;620;7;248500.0
3;1.0;1120;1.0;0;0;1120;6;225000.0
5;3.5;2730;1.0;0;1200;1530;8;542500.0
3;2.0;1280;1.0;0;0;1280;7;280000.0
4;2.5;2070;2.0;0;0;2070;7;262000.0
3;1.0;1320;1.0;0;440;880;6;268950.0
2;1.0;710;1.0;0;0;710;6;289000.0
3;2.5;1750;2.0;0;0;1750;7;300000.0
3;3.5;1240;2.0;0;240;1000;7;402000.0
3;2.25;2675;2.0;0;0;2675;8;660000.0
4;1.5;2750;1.0;0;1250;1500;7;550000.0
4;1.75;1490;1.0;0;0;1490;7;242150.0
2;2.0;1313;1.0;0;0;1313;8;885000.0
3;2.5;2830;2.0;0;0;2830;11;1075000.0
2;1.0;860;1.0;0;0;860;6;298800.0
4;2.75;2930;1.0;0;1270;1660;8;718000.0
5;3.25;5210;2.5;0;270;4940;10;2195000.0
3;1.5;1952;1.0;0;300;1652;7;270500.0
4;3.0;2370;2.0;0;620;1750;9;957000.0
4;1.75;2460;1.5;0;1010;1450;7;735000.0
5;3.5;5930;2.0;0;2010;3920;11;1520000.0
3;2.25;2730;1.0;0;1340;1390;7;345000.0
4;2.5;2030;2.0;0;0;2030;8;365500.0
3;2.0;1460;1.0;0;0;1460;7;285000.0
3;1.0;1000;1.0;0;0;1000;7;275000.0
4;3.0;2550;2.0;0;830;1720;8;855000.0
2;1.0;700;1.0;0;0;700;6;330000.0
5;2.75;3220;2.0;0;0;3220;9;798000.0
3;2.5;1440;1.0;0;0;1440;7;430000.0
4;2.25;1870;2.0;0;0;1870;7;520000.0
3;1.75;1320;1.0;0;0;1320;8;390000.0
4;4.5;5250;2.0;0;0;5250;10;915000.0
2;1.0;1350;1.0;0;430;920;7;345000.0
4;1.75;2130;1.0;0;800;1330;7;285000.0
3;2.0;1700;1.0;0;810;890;6;410000.0
5;3.0;3880;2.0;0;0;3880;7;445000.0
2;2.25;1130;2.0;0;0;1130;8;415000.0
4;2.25;1570;1.0;0;0;1570;7;350000.0
3;2.5;1820;1.0;0;910;910;7;515000.0
3;3.25;3400;2.0;0;1110;2290;9;1300000.0
3;2.5;2620;2.0;0;0;2620;7;597500.0
3;1.0;1620;1.5;0;0;1620;7;265000.0
3;2.5;2280;1.0;0;1320;960;9;557000.0
3;1.75;1260;1.0;0;0;1260;7;354000.0
3;2.5;2480;2.0;0;0;2480;7;450000.0
5;3.5;2760;2.5;0;0;2760;8;424950.0
3;1.0;860;1.0;0;0;860;6;278000.0
3;3.0;2480;2.0;0;750;1730;10;1387800.0
6;3.5;4010;1.0;0;1920;2090;8;1646000.0
2;1.0;790;1.0;0;0;790;7;425000.0
3;1.0;860;1.0;0;0;860;6;207000.0
2;1.0;1250;2.0;0;0;1250;7;463000.0
3;1.75;1290;2.0;0;230;1060;7;288790.0
2;1.0;950;1.0;0;0;950;6;330000.0
1;0.5;880;1.0;0;380;500;6;255000.0
4;1.75;2050;1.0;0;720;1330;7;485000.0
4;3.0;2720;2.0;0;0;2720;9;560000.0
3;1.5;1540;1.0;0;0;1540;7;357500.0
5;2.5;2770;2.0;0;0;2770;9;1306000.0
2;1.0;710;1.0;0;0;710;6;299000.0
4;2.0;1380;1.5;0;0;1380;7;560000.0
3;2.75;2390;1.0;0;780;1610;7;405300.0
4;2.5;2570;2.0;0;0;2570;8;320000.0
4;2.5;2000;2.0;0;0;2000;8;415000.0
4;1.0;1010;1.5;0;0;1010;6;290000.0
4;2.25;3133;2.0;0;600;2533;9;685000.0
4;2.5;1720;2.0;0;0;1720;8;295700.0
3;2.0;1370;1.0;0;0;1370;7;371500.0
3;1.75;1660;1.0;0;0;1660;7;431000.0
5;3.25;4240;2.0;0;830;3410;8;442500.0
3;2.5;2370;2.0;0;0;2370;8;429900.0
3;1.0;1520;1.0;0;0;1520;6;650000.0
4;2.25;2920;1.0;0;0;2920;11;1650000.0
5;2.25;3120;2.0;0;0;3120;9;1895000.0
4;2.5;2700;2.0;0;0;2700;9;690000.0
2;2.5;1240;3.0;0;0;1240;8;459000.0
4;1.75;1860;1.0;0;750;1110;7;265000.0
4;2.5;2480;2.0;0;0;2480;8;665000.0
3;2.5;1610;2.0;0;0;1610;8;415000.0
3;1.75;2340;2.0;0;0;2340;9;982218.0
2;1.0;860;1.0;0;0;860;7;199988.0
3;1.75;1650;1.5;0;500;1150;7;715000.0
3;2.75;1900;1.0;0;0;1900;7;255000.0
2;1.0;920;1.0;0;0;920;6;365000.0
4;4.5;3780;2.0;0;1010;2770;11;1598890.0
2;1.0;710;1.0;0;0;710;6;271000.0
3;2.5;1650;2.0;0;0;1650;7;500000.0
2;1.0;1160;1.0;0;0;1160;8;490000.0
5;2.5;2710;1.0;0;990;1720;8;1191000.0
2;1.0;1070;1.0;0;0;1070;7;350000.0
3;2.0;1480;1.0;0;400;1080;7;300000.0
3;1.75;1240;1.0;0;0;1240;7;380000.0
3;2.0;1390;2.0;0;0;1390;8;267000.0
3;2.5;2210;2.0;0;0;2210;9;509950.0
3;2.5;2440;2.0;0;0;2440;8;350000.0
5;1.75;1550;1.5;0;0;1550;7;360000.0
3;2.0;1400;1.0;0;0;1400;7;511555.0
3;2.5;2150;2.0;0;0;2150;9;649950.0
3;1.5;1920;1.0;0;0;1920;6;210000.0
0;0.0;1470;2.0;0;0;1470;7;235000.0
3;2.0;1870;1.0;0;0;1870;7;832500.0
5;3.5;3450;2.0;0;0;3450;9;525000.0
4;3.25;3910;2.0;0;1360;2550;11;1999000.0
3;1.0;1100;1.0;0;0;1100;7;392500.0
4;2.5;2160;1.0;0;1080;1080;7;650000.0
3;2.25;1580;3.0;0;0;1580;8;389950.0
5;2.5;2350;2.0;0;0;2350;9;1015000.0
2;1.0;790;1.0;0;0;790;6;212000.0
3;2.0;1910;1.0;0;910;1000;7;275000.0
3;2.25;2400;1.0;0;980;1420;8;705640.0
3;1.75;2240;2.0;0;0;2240;8;550000.0
5;2.0;2120;1.0;0;1040;1080;6;360000.0
6;3.5;3670;2.0;0;1260;2410;10;1500000.0
3;1.75;1440;1.0;0;480;960;7;315275.0
3;2.25;3250;1.0;0;990;2260;10;1150000.0
2;2.5;1780;3.0;0;0;1780;8;631500.0
4;2.75;2450;1.5;0;900;1550;7;696950.0
4;2.75;2860;1.0;0;1300;1560;7;874000.0
3;3.25;3050;2.0;0;810;2240;8;585000.0
4;3.25;3230;1.5;0;1480;1750;7;826600.0
4;1.0;1400;1.5;0;0;1400;7;185000.0
3;2.25;1358;3.0;0;0;1358;7;317000.0
3;4.0;2080;3.0;0;0;2080;8;780000.0
3;2.75;1950;1.0;0;700;1250;7;390000.0
2;2.0;1450;1.0;0;700;750;6;524000.0
2;3.0;1570;3.0;0;0;1570;8;657000.0
4;3.0;4270;2.0;0;0;4270;11;949000.0
4;3.75;3320;2.0;0;0;3320;10;1699990.0
5;2.75;2380;1.0;0;1080;1300;7;361000.0
3;2.5;1420;1.0;0;400;1020;7;260000.0
2;1.0;970;1.0;0;0;970;7;495000.0
3;1.5;2240;1.0;0;0;2240;7;495000.0
3;1.75;1470;1.0;0;0;1470;7;449950.0
3;2.5;1670;2.0;0;0;1670;8;450000.0
2;1.0;840;1.0;0;0;840;7;401000.0
3;1.0;940;1.0;0;0;940;7;725000.0
1;1.0;520;1.0;0;0;520;6;295000.0
2;1.0;930;1.0;0;0;930;6;445000.0
4;2.25;1890;2.0;0;0;1890;7;520000.0
5;3.5;2990;2.0;0;540;2450;8;750000.0
3;1.75;1420;1.0;0;0;1420;7;460000.0
3;3.0;1970;2.0;1;200;1770;9;705000.0
3;1.0;1250;1.0;0;0;1250;7;230000.0
4;2.5;2920;2.0;0;0;2920;9;690000.0
4;2.0;1940;1.0;0;0;1940;8;365000.0
3;1.75;1560;1.5;1;0;1560;6;1200000.0
6;2.75;2850;1.0;0;1000;1850;7;360000.0
3;1.75;1320;1.0;0;0;1320;7;333500.0
2;2.5;2170;1.0;0;0;2170;8;765000.0
4;2.5;2160;2.0;0;0;2160;8;345500.0
4;2.25;3500;1.0;0;1670;1830;9;879950.0
3;2.0;1820;2.0;0;0;1820;8;661000.0
6;3.0;2860;1.0;0;1430;1430;8;815000.0
3;2.25;1640;2.0;0;400;1240;6;390000.0
3;1.5;1570;1.5;0;0;1570;6;169000.0
5;2.75;1540;1.0;0;400;1140;7;357000.0
3;1.75;1550;1.0;0;720;830;6;294010.0
3;2.25;1450;2.0;0;470;980;7;482500.0
4;3.5;3906;2.0;0;0;3906;9;549950.0
3;2.25;1630;1.0;0;500;1130;7;231500.0
2;1.0;820;1.0;0;0;820;6;363000.0
2;1.0;990;1.0;0;0;990;7;747000.0
1;1.0;850;1.0;0;0;850;6;440000.0
4;1.0;1210;1.5;0;0;1210;7;364000.0
4;3.5;3440;3.0;0;0;3440;9;1285000.0
3;3.25;1720;2.0;0;360;1360;8;547500.0
3;1.75;1670;1.0;0;300;1370;7;418000.0
3;1.75;1560;1.0;0;0;1560;7;400000.0
4;3.5;3970;2.0;0;0;3970;9;775000.0
4;2.5;2100;1.0;0;860;1240;7;468000.0
5;1.5;2170;1.0;0;940;1230;7;497500.0
3;1.0;1130;1.0;0;0;1130;7;237000.0
3;2.0;1980;1.0;0;0;1980;9;479900.0
4;2.5;2470;2.0;0;0;2470;8;669000.0
4;2.75;3650;1.5;0;0;3650;8;697000.0
3;1.75;1330;1.0;0;0;1330;7;400000.0
4;2.25;2580;2.0;0;0;2580;9;787888.0
6;4.25;5480;2.0;0;340;5140;10;800000.0
3;1.75;2100;1.0;0;660;1440;8;375000.0
3;1.75;2340;1.0;0;1140;1200;6;396000.0
4;2.25;2030;2.0;0;0;2030;7;420000.0
2;1.0;1120;1.0;0;0;1120;6;216180.0
3;1.0;1260;2.0;0;0;1260;7;490000.0
4;2.0;2240;1.0;0;900;1340;8;466000.0
4;1.0;1820;2.0;0;0;1820;8;825000.0
3;1.75;2700;1.0;0;590;2110;7;625000.0
4;2.25;2450;1.0;0;0;2450;10;712000.0
3;2.5;1650;2.0;0;380;1270;7;453000.0
4;2.5;3220;2.0;0;0;3220;9;690000.0
3;2.25;1640;1.0;0;460;1180;7;575950.0
3;2.75;3270;1.5;0;0;3270;11;875000.0
4;2.25;1800;1.0;0;570;1230;7;475000.0
3;1.5;860;1.0;0;0;860;6;445000.0
4;2.5;2950;2.0;0;0;2950;7;530000.0
3;2.25;2190;1.5;0;0;2190;8;587450.0
4;2.5;3753;2.0;0;417;3336;10;363000.0
4;2.5;2820;2.0;0;0;2820;9;585000.0
3;2.5;1710;2.0;0;0;1710;7;411753.0
4;2.25;1880;2.0;0;0;1880;8;315000.0
3;1.75;1900;1.0;0;450;1450;8;770000.0
4;3.5;3320;2.0;0;0;3320;9;786000.0
2;1.5;1160;2.0;0;140;1020;8;487000.0
4;3.0;2490;1.5;0;800;1690;8;1081000.0
4;3.5;4970;2.0;0;1040;3930;11;1436000.0
4;2.25;3440;2.0;0;0;3440;10;853000.0
5;1.75;2340;2.0;0;0;2340;7;210000.0
3;1.0;970;1.0;0;0;970;7;205000.0
4;1.75;1750;1.5;0;700;1050;7;460000.0
4;3.0;3990;2.0;0;0;3990;9;810000.0
6;2.25;3040;1.0;0;1150;1890;8;330000.0
3;1.0;1200;1.0;0;0;1200;7;150000.0
3;2.0;1500;1.0;0;440;1060;7;250000.0
4;1.75;1510;1.5;0;0;1510;7;250000.0
4;3.5;3350;2.0;0;740;2610;8;844000.0
4;2.5;1700;2.0;0;0;1700;7;315000.0
3;1.0;1660;1.0;0;400;1260;7;412000.0
2;2.0;1300;1.0;0;0;1300;8;398000.0
4;3.5;4270;2.0;0;0;4270;10;1156000.0
2;1.75;1894;1.5;0;374;1520;6;280000.0
4;2.5;3010;2.0;0;0;3010;9;789500.0
4;2.5;3550;2.0;0;0;3550;10;880000.0
3;1.75;1650;1.0;0;0;1650;7;434500.0
3;1.75;1580;1.5;0;300;1280;7;536000.0
4;3.75;3460;2.0;0;0;3460;11;971971.0
5;1.75;2860;1.0;0;1430;1430;8;411000.0
3;2.0;1940;1.0;0;850;1090;7;700000.0
3;1.75;1430;1.0;0;0;1430;6;175000.0
3;1.75;1950;1.0;0;740;1210;7;484000.0
4;3.5;3350;2.0;0;800;2550;9;1010000.0
4;3.5;3460;2.0;0;900;2560;10;1315000.0
2;1.0;1090;1.0;0;310;780;7;405000.0
3;2.5;1950;2.0;0;0;1950;7;298000.0
3;2.5;2120;2.0;0;0;2120;9;719000.0
4;2.25;2060;2.0;0;0;2060;7;500000.0
4;2.5;2210;1.0;0;800;1410;8;334000.0
3;2.5;2680;2.0;0;0;2680;9;600000.0
3;2.0;1380;1.0;0;0;1380;7;295000.0
3;1.0;920;1.0;0;0;920;7;250000.0
3;1.0;1460;1.0;0;0;1460;7;395000.0
3;1.75;1430;1.0;0;0;1430;7;225000.0
3;1.5;1840;1.0;0;620;1220;8;830000.0
4;2.25;1830;2.0;0;0;1830;7;285000.0
3;1.75;1880;1.0;0;940;940;7;412000.0
4;1.75;2250;1.0;0;0;2250;7;411000.0
3;2.5;1760;2.0;0;0;1760;8;310000.0
3;1.75;1880;1.0;0;840;1040;7;600000.0
2;1.0;890;1.0;0;0;890;6;302000.0
3;2.5;2330;2.0;0;0;2330;9;710000.0
2;2.0;2090;2.0;0;0;2090;7;477500.0
3;1.0;1810;1.0;0;680;1130;7;431000.0
3;1.75;1760;1.0;0;530;1230;7;440000.0
3;1.0;1910;1.0;0;900;1010;7;490000.0
4;2.5;2060;1.0;0;620;1440;8;575550.0
3;2.5;1870;2.0;0;0;1870;7;325000.0
3;1.75;1650;1.0;0;0;1650;7;476000.0
3;3.0;2880;2.0;0;660;2220;9;1000000.0
3;2.5;3440;2.0;0;0;3440;11;610000.0
4;2.5;2340;2.0;0;0;2340;8;290000.0
3;1.5;1980;1.0;0;460;1520;8;759000.0
4;2.5;2120;2.0;0;0;2120;7;329950.0
3;2.5;1870;2.0;0;0;1870;8;345000.0
4;2.5;1910;1.0;0;750;1160;8;515000.0
5;2.0;2760;1.0;0;1380;1380;7;399950.0
3;1.75;2700;1.0;0;1190;1510;7;381000.0
4;2.5;3190;1.0;0;1510;1680;9;1216000.0
3;2.25;1810;1.0;0;360;1450;8;507000.0
6;2.25;3830;1.0;0;1390;2440;9;887000.0
2;1.5;1540;2.0;0;0;1540;7;499000.0
5;3.5;3620;2.0;0;830;2790;10;1490000.0
3;1.5;1320;1.0;0;0;1320;6;350000.0
3;2.0;1580;1.0;0;530;1050;7;480000.0
3;2.5;2680;2.0;0;0;2680;8;320000.0
3;1.75;1340;1.0;0;0;1340;7;415000.0
3;2.5;2550;2.0;0;0;2550;8;316000.0
3;1.75;1890;1.0;0;0;1890;8;575000.0
4;2.25;2300;2.0;0;0;2300;8;263850.0
5;2.75;2590;2.0;0;0;2590;8;961000.0
2;1.0;1210;1.0;0;0;1210;7;198900.0
4;2.5;2360;1.0;0;730;1630;8;840000.0
4;2.0;2000;1.5;0;0;2000;7;630000.0
3;1.5;1450;1.0;0;0;1450;7;249950.0
3;1.75;2870;1.5;0;0;2870;8;525000.0
2;1.0;800;1.0;0;0;800;7;435000.0
4;2.5;2830;2.0;0;660;2170;9;738000.0
3;2.5;2260;1.5;0;0;2260;10;777700.0
3;1.5;1300;1.0;0;400;900;7;270000.0
6;2.0;1870;1.0;0;0;1870;7;380000.0
4;2.0;2240;1.0;0;1120;1120;7;309000.0
4;1.75;2280;1.5;0;810;1470;7;665000.0
5;2.0;2020;2.0;0;0;2020;7;385000.0
4;2.5;1847;2.0;0;0;1847;7;216000.0
3;2.5;1800;1.0;0;450;1350;7;680000.0
1;1.0;730;1.0;0;0;730;4;140000.0
3;2.0;1810;1.0;0;830;980;7;760000.0
3;1.75;1590;1.0;0;0;1590;7;259000.0
4;1.5;1130;1.0;0;0;1130;7;210000.0
4;1.0;1670;1.5;0;0;1670;6;332500.0
3;1.5;2120;1.0;0;700;1420;7;325000.0
5;3.5;3900;2.0;0;1250;2650;9;1200000.0
4;2.0;2660;1.0;0;1280;1380;7;635000.0
3;1.5;1160;1.0;0;0;1160;7;210000.0
4;2.5;2050;2.0;0;0;2050;9;383000.0
2;1.0;1570;1.5;0;0;1570;8;800000.0
5;1.75;2190;1.0;0;1000;1190;7;250000.0
3;1.5;1210;1.0;0;0;1210;7;324950.0
4;3.5;2850;2.0;0;880;1970;8;710000.0
3;1.0;1190;1.0;0;0;1190;7;299500.0
3;1.5;1970;1.5;0;550;1420;8;490000.0
3;1.5;1810;1.0;0;860;950;7;261000.0
2;1.5;910;2.0;0;90;820;8;455000.0
4;2.0;1190;1.5;0;0;1190;7;329000.0
2;2.0;1290;1.0;0;340;950;7;275000.0
3;1.75;1670;1.0;0;680;990;7;280000.0
2;1.0;910;1.5;0;0;910;7;350000.0
3;1.5;2030;1.0;0;700;1330;7;404000.0
3;2.5;1980;3.0;0;0;1980;8;736000.0
5;4.0;4660;2.0;0;2060;2600;9;739000.0
2;1.75;1830;1.0;0;760;1070;7;585000.0
3;2.75;2640;1.5;0;380;2260;9;698000.0
3;1.0;1060;1.0;0;0;1060;7;220000.0
3;2.25;2110;3.0;0;0;2110;8;525000.0
2;1.0;930;1.0;0;0;930;6;235000.0
4;1.0;1450;1.5;0;0;1450;6;375000.0
4;3.0;2990;2.0;0;0;2990;10;1061600.0
3;1.5;1740;1.0;0;0;1740;7;339000.0
3;1.0;1140;1.5;0;0;1140;7;704000.0
3;1.0;1340;1.5;0;0;1340;7;568000.0
5;2.5;3490;1.0;0;1650;1840;9;915000.0
3;1.0;1260;1.0;0;0;1260;6;248000.0
3;2.5;2290;1.0;0;0;2290;8;685900.0
3;1.5;1450;1.0;0;0;1450;7;240000.0
4;2.0;1820;1.0;0;0;1820;8;519900.0
4;2.5;2650;1.0;0;320;2330;9;685000.0
3;2.25;1660;1.5;0;560;1100;7;620000.0
4;3.25;3680;2.0;0;840;2840;9;788000.0
4;3.5;3950;2.0;0;0;3950;10;771150.0
3;2.0;1540;2.0;0;0;1540;8;402000.0
2;1.0;880;1.0;0;0;880;7;415000.0
3;2.5;1500;2.0;0;0;1500;8;457500.0
2;2.0;1440;2.0;0;480;960;9;435000.0
5;3.5;4870;2.5;0;1220;3650;10;1735000.0
4;2.5;3380;2.0;0;0;3380;10;1430000.0
3;1.75;1690;1.0;0;0;1690;7;259900.0
3;3.0;1850;1.0;0;620;1230;7;355000.0
3;1.0;1010;1.0;0;0;1010;7;525000.0
3;2.5;1370;2.0;0;360;1010;7;368000.0
3;2.25;2350;1.0;0;1330;1020;7;735000.0
3;2.5;1690;2.0;0;0;1690;8;535000.0
4;3.25;2630;2.0;0;600;2030;10;855000.0
3;2.0;1230;2.0;0;220;1010;8;439950.0
4;1.0;2200;1.0;0;560;1640;8;680000.0
5;2.25;2980;1.0;0;1400;1580;9;600000.0
2;2.25;1860;2.0;0;0;1860;8;462370.0
4;2.25;1930;1.0;0;500;1430;7;312000.0
3;2.5;2550;1.0;0;800;1750;8;808000.0
3;1.0;1150;1.5;0;0;1150;6;168000.0
3;1.75;2040;1.0;0;700;1340;7;730000.0
5;4.5;2120;2.0;1;0;2120;8;1000000.0
3;1.0;1360;1.0;0;0;1360;7;159000.0
2;1.0;1000;1.0;0;0;1000;7;431000.0
2;2.25;1510;2.0;0;0;1510;7;442500.0
4;2.5;2300;2.0;0;0;2300;7;332000.0
4;1.5;1280;1.0;0;0;1280;7;367400.0
3;1.0;840;1.0;0;0;840;6;251000.0
3;1.0;990;1.0;0;0;990;7;222500.0
3;2.25;1370;3.0;0;0;1370;8;315000.0
3;2.5;1580;2.0;0;0;1580;8;379000.0
4;2.5;2540;1.0;0;0;2540;7;630000.0
3;2.5;2080;2.0;0;0;2080;8;300000.0
4;1.75;2020;1.0;0;1010;1010;7;240000.0
3;1.75;1480;1.0;0;0;1480;8;395000.0
3;2.0;2340;1.0;0;1170;1170;7;560000.0
3;1.0;1200;1.5;0;0;1200;7;280000.0
3;1.5;960;1.0;0;0;960;7;160000.0
3;1.5;1240;1.0;0;0;1240;6;390000.0
3;1.75;2200;1.0;0;960;1240;7;216600.0
2;1.0;720;1.0;0;0;720;5;330000.0
5;2.75;2481;2.0;0;0;2481;8;309000.0
3;1.75;1430;1.0;0;0;1430;7;453000.0
3;2.5;2440;1.0;0;1020;1420;7;500000.0
4;2.25;1760;2.0;0;0;1760;7;353500.0
5;3.75;3570;2.0;0;0;3570;9;624000.0
3;2.25;1270;2.0;0;210;1060;8;625504.0
4;2.5;3280;2.0;0;0;3280;7;702000.0
4;2.75;2160;1.0;0;1080;1080;7;590000.0
4;3.0;2250;1.0;0;1000;1250;7;735000.0
2;1.0;880;1.0;0;0;880;7;334550.0
3;2.5;2080;1.0;0;720;1360;8;418000.0
2;1.0;880;1.0;0;0;880;7;427550.0
3;2.5;2070;2.0;0;0;2070;8;359500.0
3;2.5;2390;2.0;0;0;2390;9;535000.0
3;1.0;990;1.0;0;0;990;7;275000.0
4;3.0;1930;1.0;0;730;1200;7;330675.0
3;2.5;1800;2.0;0;110;1690;7;475000.0
3;2.25;1450;2.0;0;0;1450;7;400000.0
3;1.0;1690;1.0;0;670;1020;7;269000.0
3;1.5;1520;1.0;0;0;1520;7;810000.0
3;2.0;1760;1.0;0;780;980;7;690000.0
4;2.75;1900;1.0;0;600;1300;7;463000.0
3;2.5;2050;2.0;0;0;2050;8;535500.0
4;3.0;4120;2.0;0;0;4120;11;1300000.0
5;2.25;1980;1.0;0;720;1260;7;307700.0
3;1.0;1290;1.5;0;0;1290;7;790000.0
3;2.0;2300;1.0;0;870;1430;8;610000.0
4;2.5;2340;2.0;0;0;2340;9;330000.0
3;1.75;1260;1.0;0;0;1260;7;245000.0
3;2.5;2000;2.0;0;0;2000;8;593700.0
5;3.5;3270;2.0;0;1090;2180;9;1305000.0
3;2.0;1830;1.0;0;600;1230;7;210000.0
5;2.25;3220;2.0;0;0;3220;8;605000.0
4;3.5;4080;2.0;0;870;3210;12;1285000.0
2;1.5;1480;1.0;0;0;1480;8;525000.0
4;2.5;2700;2.0;0;0;2700;8;725000.0
2;1.0;900;1.0;0;0;900;6;140000.0
4;2.75;2440;1.0;0;530;1910;8;785000.0
3;1.75;1320;1.0;0;0;1320;7;409950.0
4;2.75;2680;1.0;0;1340;1340;7;445000.0
4;3.0;2483;2.0;0;0;2483;8;331000.0
3;2.25;3400;2.0;0;0;3400;10;970000.0
4;2.5;2750;2.0;0;0;2750;10;1050000.0
3;1.5;1860;1.0;0;720;1140;7;291000.0
4;2.25;2530;2.0;0;0;2530;7;340000.0
3;1.75;1530;1.0;0;0;1530;7;294000.0
3;2.5;2120;2.0;0;0;2120;7;400000.0
2;1.0;830;1.0;0;0;830;7;393000.0
2;1.75;1280;1.0;0;0;1280;7;595000.0
4;2.5;1830;2.0;0;0;1830;8;325000.0
2;1.0;710;1.0;0;0;710;6;215000.0
5;2.5;3600;1.0;0;1190;2410;8;403500.0
3;2.75;3180;2.0;0;990;2190;9;850000.0
3;3.5;2876;2.0;0;516;2360;8;525000.0
6;3.75;3190;2.0;0;0;3190;8;359500.0
2;1.0;830;1.0;0;0;830;6;200000.0
5;3.25;2360;2.0;0;370;1990;8;569900.0
2;1.75;1320;1.5;0;0;1320;7;200000.0
3;2.0;1570;2.0;0;520;1050;8;765000.0
4;2.5;3630;1.5;0;1330;2300;9;400000.0
4;3.25;3160;2.0;0;800;2360;9;1250000.0
5;2.75;2670;2.0;0;0;2670;8;480000.0
3;1.0;1570;1.0;0;300;1270;8;404600.0
3;2.5;1470;1.0;0;540;930;7;435000.0
4;2.5;2870;2.0;0;0;2870;8;564000.0
2;2.0;1590;1.0;0;680;910;7;295000.0
3;1.75;2040;1.0;0;920;1120;7;555000.0
4;2.25;2020;2.0;0;310;1710;7;490000.0
2;2.75;1310;3.5;0;0;1310;8;525000.0
4;2.5;2760;2.0;0;0;2760;8;799500.0
3;1.75;1470;1.0;0;340;1130;7;328000.0
5;2.0;2880;2.0;0;0;2880;8;780000.0
4;4.0;4930;2.0;0;0;4930;12;1465000.0
4;2.5;1950;2.0;0;0;1950;8;585000.0
4;1.0;1000;1.0;0;0;1000;6;239900.0
2;1.75;1090;1.0;0;300;790;7;417000.0
3;2.5;2390;1.0;0;790;1600;8;432500.0
3;1.75;1940;1.0;0;470;1470;8;630000.0
5;1.0;1590;1.5;0;500;1090;6;185000.0
3;3.0;2150;1.5;0;610;1540;7;419950.0
4;1.5;2670;2.0;0;0;2670;8;347000.0
2;1.0;780;1.0;0;0;780;6;220000.0
3;1.5;1230;1.0;0;0;1230;7;424000.0
3;1.75;2350;1.0;0;840;1510;7;440000.0
2;1.0;1060;2.0;0;0;1060;7;353250.0
4;2.5;2750;2.0;0;790;1960;9;1030000.0
3;1.5;1480;1.0;0;480;1000;7;160000.0
3;2.5;3300;1.0;0;1650;1650;8;360500.0
4;2.5;2190;2.5;0;0;2190;8;925000.0
3;1.5;1810;1.0;0;0;1810;7;358000.0
2;1.5;1180;2.0;0;0;1180;8;399500.0
5;3.0;2257;1.0;0;894;1363;8;349950.0
3;1.0;960;1.0;0;0;960;7;235000.0
2;1.5;1480;2.0;0;240;1240;7;418000.0
3;1.75;1600;1.0;0;0;1600;8;453000.0
3;2.25;1550;3.0;0;0;1550;8;430000.0
5;3.0;2660;1.5;0;990;1670;7;335000.0
4;2.5;2100;1.0;0;800;1300;8;607000.0
3;1.75;2220;1.0;0;180;2040;8;615000.0
3;2.5;2610;2.0;0;0;2610;10;665000.0
3;2.5;2960;2.0;0;0;2960;9;740000.0
3;2.5;1390;2.0;0;0;1390;7;208800.0
4;2.25;2180;2.0;0;0;2180;8;610750.0
4;2.5;2550;2.0;0;0;2550;8;371000.0
3;2.0;2870;1.5;0;1080;1790;8;810000.0
4;2.0;2190;1.0;0;1010;1180;7;280000.0
2;1.0;1120;1.0;0;0;1120;7;465000.0
4;2.5;2810;2.0;0;0;2810;9;340000.0
2;1.0;1010;1.0;0;120;890;6;289000.0
2;1.0;1140;1.0;0;0;1140;7;695000.0
3;1.0;970;1.0;0;0;970;6;200450.0
3;3.5;4410;2.0;1;980;3430;11;3000000.0
3;2.25;3650;2.0;0;1450;2200;7;920000.0
4;2.5;1850;2.0;0;0;1850;8;325000.0
4;3.25;4020;2.0;0;0;4020;11;1050000.0
3;2.0;1690;1.0;0;0;1690;7;265000.0
4;2.25;2060;2.0;0;0;2060;7;439000.0
5;3.75;3090;2.0;0;0;3090;10;551000.0
4;1.75;1620;1.0;0;240;1380;7;657500.0
3;1.0;1530;1.0;0;640;890;7;575000.0
3;2.5;1620;2.0;0;0;1620;7;498000.0
3;1.75;1760;1.0;0;0;1760;8;575000.0
3;1.0;990;1.0;0;0;990;7;284950.0
4;2.5;2520;2.0;0;0;2520;7;450000.0
4;2.25;2080;1.0;0;630;1450;7;300000.0
3;1.5;1260;1.0;0;480;780;7;499000.0
3;2.5;2040;2.0;0;0;2040;8;208633.0
3;1.0;1570;1.0;0;0;1570;7;367500.0
4;2.5;2311;2.0;0;0;2311;9;399440.0
3;1.5;1400;3.0;0;0;1400;8;425000.0
2;1.0;930;1.0;0;200;730;6;269500.0
4;1.5;1100;1.0;0;0;1100;6;353000.0
3;2.5;1490;2.0;0;0;1490;8;316000.0
3;1.75;1930;1.0;0;700;1230;9;716500.0
4;1.75;1720;1.0;0;500;1220;7;161700.0
3;1.5;1320;1.0;0;0;1320;7;275000.0
3;2.5;1870;2.0;0;0;1870;8;445830.0
5;3.5;3700;2.0;0;810;2890;9;830000.0
3;2.0;1010;1.0;0;0;1010;7;259950.0
6;2.5;3250;1.0;0;1450;1800;8;779000.0
5;1.75;2060;1.0;0;700;1360;7;417500.0
3;2.0;1300;2.0;0;450;850;8;270000.0
4;3.0;3060;2.0;0;0;3060;8;399000.0
3;1.75;1580;1.0;0;400;1180;8;263000.0
4;1.75;1920;1.0;0;450;1470;7;719521.0
3;1.75;1570;1.0;0;0;1570;7;439995.0
3;1.75;1330;1.0;0;0;1330;8;601000.0
3;1.75;1540;1.0;0;500;1040;6;433500.0
3;2.0;1770;3.0;0;0;1770;8;660000.0
4;2.0;3510;1.0;0;1300;2210;8;554820.0
3;1.5;1120;1.0;0;0;1120;7;266000.0
3;2.5;1970;2.0;0;0;1970;7;420000.0
3;2.0;2190;1.0;0;930;1260;7;769950.0
3;2.5;2260;2.0;0;0;2260;8;325000.0
4;2.75;2250;1.0;0;1050;1200;8;648475.0
4;2.5;2180;1.0;0;990;1190;7;330000.0
3;2.0;2050;1.0;0;880;1170;7;399950.0
2;1.0;760;1.0;0;0;760;6;261590.0
3;2.5;1690;3.0;0;270;1420;8;492000.0
3;1.0;1250;1.0;0;0;1250;7;221000.0
6;3.0;2790;2.5;0;0;2790;8;700000.0
2;1.5;1240;2.0;0;40;1200;8;277700.0
3;1.5;850;1.0;0;0;850;7;295000.0
2;1.0;990;1.0;0;0;990;6;409950.0
5;3.75;4570;2.0;0;0;4570;11;1037000.0
4;2.5;1961;2.0;0;0;1961;7;289000.0
4;2.5;3360;2.0;0;0;3360;9;950000.0
4;2.75;2190;2.0;0;0;2190;7;361500.0
3;2.0;2240;1.0;0;610;1630;7;375000.0
2;1.0;720;1.0;0;0;720;6;419000.0
3;2.0;2160;1.0;0;0;2160;10;895000.0
3;2.5;1780;2.0;0;0;1780;7;309000.0
3;2.25;3040;1.0;0;0;3040;9;1000000.0
4;2.0;2430;1.0;0;1000;1430;7;255000.0
3;1.5;1490;1.0;0;480;1010;7;285000.0
4;4.5;6640;2.0;0;0;6640;12;1820000.0
3;1.0;910;1.0;0;0;910;7;565000.0
3;2.25;2110;2.0;0;0;2110;8;385000.0
2;2.5;809;2.0;0;0;809;7;219000.0
2;1.75;1460;1.0;0;0;1460;7;220650.0
3;2.5;3110;2.0;0;0;3110;9;700000.0
3;1.0;1090;1.0;0;0;1090;6;152500.0
2;1.0;1530;1.0;0;400;1130;7;458950.0
3;1.75;2130;1.0;0;550;1580;8;310000.0
3;2.5;2220;3.0;0;0;2220;10;641250.0
5;3.5;3160;2.0;0;0;3160;9;660000.0
5;2.75;2350;1.5;0;830;1520;8;585000.0
3;1.0;1230;1.0;0;0;1230;7;392000.0
3;2.75;2950;2.0;0;0;2950;9;739000.0
2;1.5;1160;1.0;0;0;1160;7;365000.0
6;4.5;3300;2.0;0;0;3300;8;510000.0
4;2.25;2240;2.0;0;0;2240;8;980000.0
4;2.0;2070;1.0;0;0;2070;7;375000.0
4;2.75;3330;2.0;0;0;3330;10;1095000.0
5;2.5;2100;1.0;0;700;1400;7;309900.0
3;2.5;2100;2.0;0;0;2100;7;477000.0
3;3.25;4460;2.0;0;0;4460;9;739500.0
3;1.0;1300;1.5;0;0;1300;7;455000.0
3;2.5;2820;1.0;0;1040;1780;9;705000.0
4;2.5;2300;2.0;0;0;2300;7;392000.0
2;1.0;1180;1.0;0;240;940;7;600000.0
3;2.25;2120;2.0;0;0;2120;9;835000.0
3;2.5;2290;2.0;0;0;2290;9;590000.0
3;2.5;2160;1.0;0;800;1360;7;405000.0
4;2.5;2301;2.0;0;0;2301;9;375500.0
4;3.25;2864;3.0;0;0;2864;8;380000.0
4;1.75;1670;1.0;0;600;1070;7;349170.0
3;2.0;1060;1.0;0;0;1060;7;315000.0
4;2.5;2640;2.0;0;0;2640;8;570000.0
4;2.5;2890;2.0;0;0;2890;8;300000.0
3;1.0;1320;1.5;0;0;1320;7;279000.0
4;2.0;1580;1.0;0;530;1050;7;300000.0
5;2.25;2760;1.0;0;1380;1380;7;600000.0
1;1.0;530;1.0;0;0;530;5;238000.0
5;3.0;1980;1.0;0;760;1220;7;333800.0
3;1.0;1390;1.0;0;0;1390;7;396000.0
4;2.75;2300;1.0;0;740;1560;7;315000.0
3;1.0;1490;1.5;0;0;1490;7;578500.0
4;3.75;2690;2.0;0;570;2120;9;800000.0
2;1.0;1020;1.0;0;0;1020;6;175000.0
5;4.5;6200;3.0;0;1150;5050;11;1959000.0
4;2.5;2590;2.0;0;0;2590;9;500000.0
4;2.5;2570;1.0;0;1060;1510;8;795000.0
3;1.5;1300;1.0;0;0;1300;7;365000.0
5;2.0;2050;1.0;0;620;1430;6;475000.0
4;2.75;2470;1.0;0;1190;1280;8;430000.0
3;2.0;1550;1.0;0;0;1550;8;300000.0
3;1.5;1460;1.0;0;0;1460;7;465000.0
3;1.0;960;1.0;0;0;960;7;545000.0
3;2.5;1810;1.0;0;600;1210;7;420000.0
4;1.75;1740;1.0;0;0;1740;7;600000.0
5;3.0;3640;2.0;0;1100;2540;10;1595000.0
3;1.0;1040;1.0;0;0;1040;6;234000.0
4;2.5;2710;2.0;0;0;2710;9;455000.0
3;2.5;2070;2.0;0;0;2070;8;542950.0
3;2.5;1470;2.0;0;540;930;8;397500.0
4;2.25;2630;2.0;0;820;1810;9;1045000.0
3;3.5;1900;2.0;0;380;1520;8;420000.0
4;2.25;2360;2.0;0;0;2360;8;577000.0
4;1.75;2000;1.0;0;880;1120;8;725000.0
4;2.75;2510;1.0;0;460;2050;8;704000.0
5;2.0;2500;1.5;0;930;1570;7;425000.0
4;3.25;3950;2.0;0;0;3950;10;1780000.0
3;2.0;1400;1.0;0;700;700;7;432000.0
3;1.0;1010;1.0;0;0;1010;7;200000.0
4;1.75;2400;1.0;0;810;1590;8;569000.0
3;1.0;1070;1.0;0;0;1070;7;385000.0
4;2.5;2030;2.0;0;0;2030;8;295000.0
4;1.0;1140;1.0;0;240;900;7;410000.0
4;2.25;2380;1.0;0;0;2380;8;594950.0
3;2.5;2880;2.0;0;0;2880;7;450000.0
3;2.0;1340;1.0;0;0;1340;7;265000.0
4;2.5;3430;2.0;0;0;3430;10;813000.0
4;2.5;3362;2.0;0;0;3362;8;410500.0
6;2.5;3760;1.0;0;1400;2360;9;838300.0
3;1.75;1520;1.0;0;350;1170;7;550000.0
2;1.0;800;1.0;0;200;600;6;330000.0
4;2.5;2190;1.0;0;1080;1110;7;370000.0
2;1.0;1230;1.5;0;350;880;7;575000.0
3;2.25;1630;1.0;0;400;1230;7;490000.0
3;1.5;1230;1.0;0;0;1230;7;147500.0
3;2.75;3400;2.0;0;930;2470;9;530000.0
3;1.75;1340;1.0;0;0;1340;7;385000.0
4;1.0;1320;1.5;0;0;1320;7;229000.0
3;1.75;1300;1.0;0;0;1300;7;369000.0
2;1.5;1310;1.5;0;0;1310;6;455000.0
4;2.25;2190;1.0;0;1150;1040;7;289950.0
3;1.75;1800;1.0;0;900;900;6;381000.0
3;1.0;1190;1.0;0;0;1190;6;288000.0
4;2.5;3260;2.0;0;0;3260;9;810000.0
5;2.5;2780;1.0;0;1390;1390;8;290000.0
4;3.5;2170;2.0;0;0;2170;9;1325000.0
4;2.5;2390;2.0;0;0;2390;9;647000.0
4;2.0;1980;2.0;0;280;1700;8;900000.0
3;1.75;2310;2.0;0;0;2310;8;588000.0
3;1.0;1400;1.5;0;0;1400;7;348125.0
4;2.0;1960;1.0;0;1000;960;8;745000.0
3;1.5;1610;2.0;0;0;1610;7;270000.0
3;1.0;1590;1.0;0;310;1280;8;579000.0
4;3.75;2400;1.0;0;1030;1370;7;885000.0
1;1.0;2880;1.0;0;1440;1440;7;550000.0
3;1.75;2110;1.0;0;0;2110;8;400000.0
2;1.5;1140;3.0;0;0;1140;7;466000.0
2;1.0;820;1.0;0;0;820;5;185000.0
3;1.0;1400;1.0;0;600;800;7;349500.0
4;2.5;2223;2.0;0;0;2223;8;320000.0
4;1.75;1700;1.0;0;380;1320;8;429950.0
3;2.25;2120;2.0;0;0;2120;7;289500.0
3;1.75;1930;1.0;0;0;1930;8;295000.0
4;2.25;2040;1.0;0;770;1270;8;366400.0
3;2.25;2060;1.0;0;460;1600;8;335000.0
3;2.5;2380;2.0;0;0;2380;8;582000.0
4;1.75;1440;1.0;0;0;1440;8;1038000.0
3;1.0;1030;1.0;0;0;1030;7;718000.0
3;3.0;4610;2.0;0;1820;2790;8;1245000.0
3;2.75;2730;1.5;1;790;1940;9;1338750.0
2;1.0;880;1.0;0;0;880;6;326100.0
2;1.5;790;2.0;0;90;700;8;365000.0
3;2.5;1900;2.0;0;0;1900;7;536000.0
3;1.0;1020;1.0;0;0;1020;7;335000.0
3;2.0;2020;1.0;0;1000;1020;7;507500.0
4;2.5;2310;2.0;0;0;2310;8;310000.0
4;2.5;2610;2.0;0;0;2610;8;350000.0
5;1.75;2500;1.0;0;940;1560;9;840000.0
2;3.25;2070;2.0;1;310;1760;9;1452000.0
6;3.0;3020;2.0;0;0;3020;8;900000.0
3;2.5;1730;1.0;0;370;1360;7;269000.0
3;1.0;1130;1.5;0;0;1130;7;375000.0
3;1.0;1230;1.0;0;0;1230;7;278000.0
3;2.0;2540;1.0;0;0;2540;9;600000.0
3;1.5;1320;1.0;0;0;1320;7;370000.0
2;1.5;1630;1.0;0;740;890;7;448000.0
3;1.75;1500;1.0;0;650;850;7;700000.0
3;2.5;1580;2.0;0;0;1580;8;485000.0
4;2.5;2390;2.0;0;0;2390;9;675000.0
4;2.0;2100;1.0;0;0;2100;7;500000.0
4;2.5;2090;2.0;0;0;2090;8;545000.0
3;1.75;1580;1.0;0;480;1100;7;279900.0
3;2.25;1770;1.0;0;440;1330;8;327500.0
3;2.5;2320;1.0;0;0;2320;8;728050.0
3;2.25;2120;2.0;0;0;2120;7;278000.0
3;2.5;1740;2.0;0;0;1740;9;645000.0
4;2.5;2900;2.0;0;0;2900;8;527000.0
5;1.75;3250;1.0;0;1600;1650;8;463828.0
3;2.25;1654;2.0;0;0;1654;7;314950.0
3;2.25;2420;1.0;0;0;2420;8;774888.0
3;2.5;2300;1.0;0;0;2300;8;738500.0
3;2.25;1500;1.0;0;350;1150;7;219950.0
1;1.0;1050;1.0;0;0;1050;6;210000.0
2;2.0;1140;1.0;0;0;1140;6;480000.0
3;1.0;1530;1.0;0;0;1530;7;640000.0
4;2.0;2070;1.0;0;890;1180;7;699950.0
3;2.5;1330;3.0;0;0;1330;7;300000.0
4;2.5;3500;2.0;0;0;3500;10;917000.0
3;2.0;1660;2.0;0;0;1660;8;269950.0
4;2.25;2090;2.0;0;0;2090;8;546200.0
3;2.0;1670;1.0;0;520;1150;7;520000.0
3;3.0;1860;1.0;0;820;1040;7;301350.0
3;2.25;1590;1.0;0;500;1090;7;190000.0
4;3.5;3080;2.0;0;0;3080;9;775000.0
4;2.5;3320;2.0;0;0;3320;9;675000.0
3;1.0;1540;1.0;0;0;1540;7;350000.0
4;2.5;1850;2.0;0;0;1850;7;295000.0
3;2.25;1820;1.0;0;340;1480;7;480000.0
4;2.5;3890;2.0;0;0;3890;10;775000.0
3;2.25;1670;1.0;0;450;1220;7;580000.0
2;1.0;1040;1.0;0;100;940;7;425000.0
2;2.5;1620;2.0;0;0;1620;7;475000.0
2;2.25;1800;2.0;0;0;1800;9;542000.0
3;2.5;1670;2.0;0;0;1670;8;475200.0
4;1.75;1950;1.0;0;910;1040;7;601000.0
2;1.5;1160;2.0;0;0;1160;7;340000.0
4;2.75;1540;1.0;0;690;850;7;450000.0
5;3.75;4360;2.0;0;830;3530;10;1789950.0
3;2.5;1260;1.0;0;0;1260;7;312620.0
4;2.5;3210;2.0;0;0;3210;10;770000.0
4;1.5;2270;1.0;0;980;1290;8;676101.0
4;3.5;3660;2.0;0;820;2840;9;1107460.0
4;1.75;2110;1.0;0;940;1170;8;324000.0
3;2.5;1740;3.0;0;0;1740;8;568000.0
5;1.0;1590;1.5;0;400;1190;7;518000.0
3;2.0;1440;2.0;0;0;1440;6;509990.0
3;1.75;1410;1.5;0;0;1410;7;541000.0
3;1.5;1440;1.0;0;0;1440;7;253500.0
5;2.75;2920;1.5;0;1120;1800;7;265000.0
2;1.0;800;1.0;0;130;670;6;410000.0
2;1.0;680;1.0;0;0;680;6;500000.0
3;1.0;2710;2.0;0;0;2710;7;410000.0
7;2.5;2580;1.0;0;700;1880;7;599000.0
3;2.5;1330;3.0;0;0;1330;8;539950.0
4;2.5;2770;2.0;0;0;2770;9;438800.0
3;2.5;2250;2.0;0;0;2250;8;550000.0
3;1.75;1320;1.0;0;0;1320;7;292000.0
4;1.75;1730;1.0;0;720;1010;7;280400.0
3;3.0;2360;2.0;0;580;1780;7;498000.0
3;2.25;2190;2.0;0;0;2190;8;699950.0
5;2.5;3320;2.0;0;0;3320;9;805000.0
2;0.75;890;1.0;0;0;890;6;230000.0
4;2.5;2620;2.0;0;0;2620;8;399963.0
4;1.75;1770;1.0;0;0;1770;8;350000.0
5;1.75;2110;1.5;0;860;1250;7;674000.0
3;2.5;1440;2.0;0;0;1440;7;287450.0
3;2.0;1660;1.0;0;0;1660;7;343500.0
3;2.0;1820;1.0;0;700;1120;7;655000.0
4;2.5;2400;2.0;0;0;2400;8;333000.0
2;1.75;1330;1.0;0;0;1330;7;440000.0
4;1.0;1660;1.5;0;400;1260;7;548800.0
2;1.75;1030;2.0;0;265;765;7;345000.0
5;3.75;3760;2.0;0;980;2780;9;799950.0
4;1.0;1190;1.5;0;0;1190;6;312000.0
3;1.5;1630;1.0;0;650;980;7;230000.0
4;1.5;1660;1.0;0;0;1660;7;399500.0
4;2.25;2070;1.0;0;370;1700;8;795000.0
3;1.0;1410;1.0;0;0;1410;7;440000.0
3;1.5;1180;3.0;0;0;1180;7;435000.0
3;1.0;1570;2.0;0;0;1570;7;685000.0
3;2.5;1590;2.0;0;0;1590;7;285000.0
3;1.75;1910;1.0;0;800;1110;8;595000.0
3;1.5;2240;2.0;0;870;1370;8;510000.0
5;3.0;2730;1.0;0;1060;1670;8;559950.0
3;0.75;850;1.0;0;250;600;6;132500.0
3;1.5;1510;1.5;0;0;1510;7;230000.0
3;2.25;1260;2.0;0;0;1260;7;425000.0
3;2.5;1480;2.0;0;0;1480;8;450000.0
3;1.75;1270;1.0;0;0;1270;7;340000.0
3;2.5;2040;2.0;0;0;2040;8;319900.0
4;2.5;2641;2.0;0;0;2641;7;393000.0
4;2.5;2020;2.0;0;0;2020;7;360000.0
4;2.25;2030;2.0;0;0;2030;8;579000.0
4;2.5;1630;2.0;0;0;1630;7;327000.0
3;3.5;1570;2.5;0;240;1330;8;494000.0
3;2.25;2150;1.0;0;700;1450;8;458000.0
3;1.75;1310;2.0;0;0;1310;7;600000.0
4;2.5;3020;2.0;0;0;3020;9;715000.0
4;1.75;1520;1.0;0;0;1520;7;499950.0
4;2.5;2480;2.0;0;0;2480;8;399000.0
4;2.5;2250;2.0;0;0;2250;8;600000.0
4;3.0;2150;2.0;0;0;2150;8;1200000.0
3;1.75;1700;1.0;0;520;1180;7;263950.0
5;3.0;2560;1.0;0;970;1590;8;565000.0
3;1.0;1460;1.0;0;0;1460;8;399000.0
4;3.5;4060;2.0;0;0;4060;10;1600000.0
5;3.75;3880;2.0;0;0;3880;7;506000.0
2;1.0;960;1.0;0;0;960;6;365000.0
3;1.75;2120;1.0;0;840;1280;7;428000.0
3;2.25;1610;2.0;0;0;1610;7;290000.0
4;1.75;2200;1.0;0;1100;1100;7;414950.0
4;2.5;2070;1.0;0;820;1250;8;775000.0
4;2.0;2430;1.0;0;1120;1310;8;449500.0
5;3.0;2670;1.0;0;1300;1370;7;515000.0
4;2.0;2280;1.0;0;1140;1140;7;628000.0
4;2.5;2510;1.0;0;900;1610;8;319000.0
3;2.25;2930;2.0;0;1010;1920;11;1385000.0
4;2.5;2740;2.0;0;0;2740;9;476000.0
3;2.0;2270;1.0;0;350;1920;7;340500.0
3;1.75;1840;1.0;0;500;1340;8;366000.0
3;1.0;1310;1.0;0;0;1310;7;420000.0
3;2.0;1940;1.0;0;970;970;7;651000.0
3;1.5;1550;1.0;0;470;1080;7;359000.0
1;1.0;720;1.0;0;0;720;6;185000.0
3;3.5;4360;2.0;0;1400;2960;10;1555000.0
3;3.5;2670;2.0;0;800;1870;9;825000.0
3;1.0;1020;1.5;0;0;1020;7;180000.0
3;2.25;1552;2.0;0;0;1552;7;282000.0
3;3.25;1450;2.0;0;350;1100;8;380000.0
2;1.0;840;1.0;0;0;840;6;295000.0
4;3.5;2000;3.0;0;0;2000;8;456500.0
3;2.5;2080;2.0;0;0;2080;8;550000.0
5;2.0;1820;1.0;0;910;910;7;393000.0
3;2.25;1700;3.0;0;0;1700;8;550000.0
3;2.0;1550;1.0;0;610;940;7;545000.0
3;2.5;2060;2.0;0;0;2060;8;840000.0
3;2.25;2630;2.5;0;0;2630;8;1442500.0
3;2.5;2940;2.0;0;0;2940;10;780000.0
3;2.5;2570;2.0;0;0;2570;11;1475000.0
3;1.0;1170;1.0;0;0;1170;7;312500.0
4;2.5;2580;2.0;0;0;2580;8;552250.0
4;1.75;2310;1.0;0;530;1780;7;350000.0
3;3.0;4230;2.0;0;450;3780;9;887500.0
3;2.5;1870;2.0;0;0;1870;8;377000.0
3;2.5;2650;2.0;0;0;2650;9;770000.0
4;1.5;2060;1.0;0;0;2060;8;815000.0
3;1.5;1260;2.0;0;220;1040;7;245000.0
4;2.5;1820;2.0;0;0;1820;7;329500.0
4;3.25;4280;2.0;0;1230;3050;10;734950.0
2;2.5;1170;2.0;0;0;1170;8;325000.0
3;1.75;2330;1.0;0;1010;1320;8;650000.0
3;2.0;1590;1.0;0;530;1060;7;250000.0
3;1.5;1890;1.0;0;800;1090;7;400000.0
4;2.25;2820;1.0;0;870;1950;8;750000.0
3;2.5;3090;2.0;0;0;3090;10;751000.0
5;2.75;3080;2.0;0;0;3080;9;579950.0
3;2.5;2870;2.0;0;0;2870;9;880000.0
3;2.25;2930;3.0;0;260;2670;9;1047500.0
4;2.25;1964;2.0;0;0;1964;9;342000.0
3;2.25;2100;2.0;0;0;2100;8;600000.0
3;2.0;1980;1.0;0;600;1380;7;637000.0
3;1.0;1050;1.0;0;0;1050;7;400000.0
4;2.5;2090;2.0;0;0;2090;8;405000.0
2;1.5;920;2.0;0;0;920;7;265000.0
2;1.0;980;1.0;0;0;980;7;390000.0
4;3.5;4000;2.0;0;0;4000;9;762000.0
3;1.75;1510;1.0;0;0;1510;7;441500.0
5;2.75;3831;2.0;1;0;3831;9;2700000.0
2;1.0;790;1.0;0;0;790;7;198000.0
4;1.5;2340;2.0;0;240;2100;8;730000.0
4;1.0;1080;1.5;0;0;1080;5;275000.0
3;2.75;2150;2.0;0;0;2150;9;595000.0
3;2.25;2190;1.0;0;950;1240;8;539950.0
3;1.75;2060;1.0;0;1030;1030;7;499950.0
4;2.5;2190;2.0;0;0;2190;8;563500.0
3;1.75;1640;1.0;0;550;1090;7;556000.0
4;1.75;1930;1.0;0;800;1130;8;495000.0
4;3.5;1880;3.0;0;230;1650;8;545000.0
3;2.75;2850;1.0;0;930;1920;9;775000.0
4;1.5;1600;1.0;0;0;1600;7;224000.0
3;2.0;1440;1.0;0;0;1440;8;350000.0
4;1.75;3730;1.0;0;1580;2150;7;360000.0
4;1.75;2520;1.0;0;1260;1260;7;272000.0
3;1.75;1710;1.0;0;470;1240;7;260000.0
3;1.75;1850;1.0;0;970;880;7;450000.0
3;3.0;2090;1.5;0;800;1290;7;700000.0
4;2.0;2340;1.0;0;1170;1170;7;568000.0
4;1.75;2030;2.0;0;300;1730;9;550000.0
4;2.0;3140;1.0;0;1100;2040;8;925000.0
4;2.5;2920;2.0;0;0;2920;9;555000.0
2;1.0;830;1.0;0;0;830;6;235000.0
3;3.25;2730;2.0;0;830;1900;10;981000.0
3;1.0;1470;1.0;0;450;1020;7;238000.0
4;2.0;2290;1.5;0;0;2290;7;685000.0
4;2.75;3130;2.0;0;0;3130;8;690500.0
3;1.0;1070;1.0;0;0;1070;7;147000.0
2;1.0;750;1.0;0;0;750;7;319000.0
2;1.0;1220;1.0;0;340;880;6;452000.0
4;4.25;4590;2.0;0;1430;3160;10;1135000.0
3;1.75;2190;1.0;0;0;2190;7;375000.0
1;1.75;1440;1.0;0;720;720;7;390000.0
3;1.0;1120;1.0;0;0;1120;7;615000.0
3;1.0;1500;2.0;0;200;1300;7;415000.0
3;1.0;1140;1.5;0;0;1140;6;160000.0
2;1.0;1370;1.0;0;240;1130;8;703011.0
3;2.25;2510;1.0;0;900;1610;8;267000.0
3;1.5;1320;2.0;0;0;1320;7;269000.0
4;3.5;4140;2.0;0;0;4140;11;950000.0
2;2.0;1651;1.0;0;0;1651;6;285000.0
4;2.5;2520;1.0;0;1000;1520;8;565000.0
4;2.5;3000;2.0;0;0;3000;8;585000.0
3;1.75;1710;1.0;0;580;1130;7;480000.0
5;2.5;3070;2.0;0;0;3070;8;575000.0
3;1.75;1050;1.0;0;0;1050;7;199000.0
3;2.5;1660;3.0;0;50;1610;7;605000.0
3;1.75;1430;1.0;0;0;1430;7;427500.0
3;1.75;1410;1.0;0;0;1410;7;255000.0
3;2.75;1430;2.0;0;300;1130;9;580000.0
3;2.5;2390;1.0;0;690;1700;9;1350000.0
3;2.5;1260;3.0;0;0;1260;8;479000.0
3;1.0;1230;1.0;0;0;1230;7;275000.0
4;2.5;2303;2.0;0;0;2303;8;300000.0
5;2.5;2130;2.0;0;0;2130;7;380000.0
3;2.25;2240;2.0;0;0;2240;9;600000.0
4;2.5;2160;2.5;0;0;2160;9;842500.0
2;1.0;990;1.0;0;120;870;7;435000.0
3;1.5;1970;1.0;0;0;1970;6;289000.0
4;2.5;2880;2.0;0;940;1940;9;635000.0
4;2.5;1840;2.0;0;0;1840;8;620000.0
3;2.25;2800;2.0;0;0;2800;9;408000.0
2;1.0;1270;1.0;0;170;1100;7;611000.0
4;2.75;2610;1.0;0;1300;1310;8;320000.0
4;3.5;3130;2.0;0;1070;2060;9;1375000.0
2;2.25;1280;2.0;0;0;1280;7;364000.0
2;1.0;930;1.0;0;0;930;7;395000.0
3;1.75;1650;1.0;0;550;1100;7;234975.0
2;2.0;1180;1.0;0;590;590;6;360000.0
4;2.5;2320;2.0;0;0;2320;7;340000.0
8;6.0;4340;2.0;0;0;4340;8;2150000.0
4;2.75;3410;2.0;0;0;3410;10;870000.0
3;2.0;1410;1.0;0;0;1410;6;340000.0
4;2.5;2390;1.0;0;800;1590;9;800000.0
3;2.5;2650;2.0;0;0;2650;9;660000.0
4;2.75;3150;1.0;0;1340;1810;8;750000.0
3;1.75;1570;1.0;0;490;1080;7;371000.0
3;1.0;1320;1.0;0;0;1320;7;206000.0
4;2.75;2720;2.0;0;0;2720;8;680000.0
3;1.0;1640;1.5;0;0;1640;7;716100.0
4;2.5;2140;2.0;0;0;2140;7;495000.0
3;1.0;1200;1.0;0;0;1200;7;345000.0
4;2.5;1850;2.0;0;0;1850;7;278000.0
3;2.0;1340;1.0;0;0;1340;6;215000.0
3;2.5;1880;2.0;0;0;1880;7;300000.0
2;1.0;860;1.0;0;0;860;5;187000.0
3;1.5;1660;2.0;0;0;1660;7;220000.0
3;2.75;1850;1.5;0;0;1850;7;489200.0
3;2.5;2075;2.0;0;0;2075;8;433200.0
11;3.0;3000;2.0;0;600;2400;7;520000.0
4;1.0;1710;1.5;0;0;1710;7;433000.0
5;4.75;6200;2.0;1;1760;4440;11;3300000.0
4;1.75;1990;1.0;0;140;1850;8;524400.0
3;1.75;1700;1.5;0;0;1700;6;545000.0
3;2.5;1990;1.5;0;600;1390;8;579000.0
4;3.5;3680;2.5;0;1010;2670;9;770000.0
3;1.75;1230;2.0;0;220;1010;8;393500.0
4;2.5;2040;2.0;0;0;2040;7;240000.0
5;3.0;3290;1.0;0;1420;1870;7;695000.0
3;4.25;5150;2.5;0;980;4170;11;2250000.0
4;1.75;1840;1.0;0;750;1090;7;279000.0
3;1.5;1440;1.0;0;0;1440;7;224000.0
2;1.0;940;1.0;0;0;940;7;352000.0
3;2.75;3900;2.0;0;440;3460;6;415000.0
4;3.5;3120;2.0;0;640;2480;9;953007.0
5;2.0;2270;1.0;0;1120;1150;7;513000.0
4;2.5;3320;2.0;0;0;3320;9;799950.0
3;1.75;2220;1.0;0;1110;1110;7;435000.0
4;1.75;1720;2.0;0;0;1720;7;235000.0
4;1.75;1520;1.0;0;0;1520;6;450000.0
5;3.75;5350;1.0;0;2310;3040;11;3345000.0
4;2.0;2290;1.0;0;0;2290;8;1058000.0
2;1.0;950;1.0;0;0;950;6;230000.0
3;2.5;1690;2.0;0;280;1410;8;338000.0
3;1.75;1500;1.0;0;0;1500;7;418000.0
4;2.5;3172;2.0;0;0;3172;8;432500.0
4;1.5;2190;2.0;0;0;2190;7;565000.0
4;2.5;2220;2.0;0;0;2220;8;334990.0
4;3.0;1960;1.0;0;790;1170;7;277000.0
4;1.75;2190;1.0;0;740;1450;7;725000.0
5;3.5;3090;2.0;0;1030;2060;9;1112750.0
4;2.5;2910;2.0;0;970;1940;10;1100000.0
3;1.0;1040;1.0;0;0;1040;7;339888.0
4;2.5;4570;2.0;0;0;4570;12;1580000.0
3;2.25;1920;1.0;0;360;1560;8;652000.0
3;2.5;1490;2.0;0;0;1490;7;237000.0
3;2.75;2820;2.0;0;0;2820;9;749000.0
2;1.0;700;1.0;0;0;700;7;400000.0
4;1.0;1650;1.0;0;0;1650;7;282500.0
3;2.5;1360;2.0;0;0;1360;7;239000.0
3;1.75;1120;1.0;0;260;860;6;355000.0
4;2.0;1510;1.5;0;0;1510;7;791500.0
2;1.0;1130;1.0;0;0;1130;6;384500.0
4;2.5;2070;2.0;0;0;2070;8;372000.0
4;2.0;1190;1.5;0;0;1190;7;900000.0
3;2.0;1180;2.0;0;0;1180;8;425000.0
3;2.5;2650;2.0;0;0;2650;8;446500.0
6;3.0;3470;1.5;0;0;3470;7;475000.0
3;1.0;960;1.0;0;0;960;6;200000.0
4;1.0;1150;1.5;0;0;1150;6;225000.0
5;2.5;2520;1.5;0;630;1890;7;392400.0
2;1.0;990;1.0;0;0;990;7;219950.0
4;2.5;2701;2.0;0;0;2701;7;270000.0
4;2.5;1790;1.0;0;0;1790;7;244950.0
4;2.5;2130;1.0;0;640;1490;8;580000.0
4;2.75;2990;1.0;0;1110;1880;8;350000.0
3;2.5;2400;2.0;0;0;2400;8;592000.0
3;1.0;1090;1.0;0;200;890;6;220000.0
3;2.5;2520;1.0;0;890;1630;8;685000.0
3;2.0;1360;1.0;0;0;1360;6;763000.0
2;2.25;930;2.0;0;300;630;8;355000.0
3;2.5;2400;2.0;0;0;2400;8;540000.0
3;2.0;1410;1.0;0;0;1410;7;271920.0
4;3.0;2680;2.0;0;0;2680;8;1160000.0
3;2.0;1880;1.0;0;600;1280;8;625000.0
3;2.5;2500;2.0;0;0;2500;8;539900.0
4;3.5;3010;2.0;0;640;2370;9;1280000.0
3;2.0;1380;1.0;0;630;750;7;435000.0
4;3.0;3610;2.0;0;0;3610;10;510000.0
4;1.75;1460;1.0;0;0;1460;7;427000.0
2;1.0;690;1.0;0;0;690;5;139000.0
3;1.75;2330;1.0;0;740;1590;8;680000.0
4;2.5;2590;2.0;0;0;2590;8;479000.0
4;2.5;2040;2.0;0;0;2040;7;279000.0
3;3.0;1800;1.5;0;300;1500;8;606400.0
3;2.75;2000;1.0;0;750;1250;7;538000.0
3;2.5;2490;2.0;0;0;2490;9;700000.0
4;3.25;3480;3.0;0;0;3480;8;1850000.0
3;2.5;1640;2.0;0;0;1640;7;300000.0
2;1.75;1090;1.0;0;0;1090;8;149900.0
6;4.75;5540;2.5;0;1590;3950;11;2630000.0
4;1.75;1830;1.0;0;900;930;7;639000.0
2;1.0;1540;1.0;0;720;820;7;615000.0
3;1.0;1260;1.5;0;0;1260;7;485000.0
3;1.5;1390;2.0;0;0;1390;7;267500.0
4;1.75;1730;1.0;0;0;1730;7;320000.0
4;2.75;2260;2.0;0;0;2260;8;359950.0
2;1.0;790;1.0;0;0;790;6;268500.0
4;2.25;3310;1.0;0;1650;1660;9;1100000.0
5;2.25;2100;1.0;0;500;1600;8;567000.0
4;3.25;3430;2.0;0;0;3430;9;749995.0
2;1.0;1320;1.0;0;0;1320;6;215000.0
4;2.5;2440;2.0;0;0;2440;9;749500.0
3;2.0;1270;1.5;0;0;1270;7;247000.0
3;1.0;1680;1.0;0;840;840;7;350000.0
4;2.5;2460;2.0;0;0;2460;9;427500.0
3;2.5;1610;2.0;0;370;1240;8;320000.0
4;2.25;1790;1.0;0;680;1110;7;430000.0
5;2.5;3000;1.0;0;1390;1610;9;770000.0
2;1.0;1580;2.0;0;0;1580;8;720000.0
2;2.25;2770;1.0;0;1200;1570;8;645000.0
3;1.5;1400;1.0;0;0;1400;7;252000.0
5;2.0;2560;1.0;0;1280;1280;8;585000.0
2;1.0;1390;1.0;0;0;1390;6;354000.0
3;1.0;1160;1.0;0;0;1160;7;315500.0
3;2.5;2100;2.0;0;0;2100;8;554990.0
3;1.0;1210;1.5;0;0;1210;7;315000.0
5;1.5;2240;1.0;0;960;1280;8;534950.0
4;2.5;3100;2.0;0;0;3100;9;449950.0
2;1.75;2170;1.0;0;0;2170;8;850000.0
4;2.25;2380;1.0;0;840;1540;7;699900.0
4;2.5;1940;2.0;0;0;1940;8;420000.0
3;1.75;1380;1.0;0;0;1380;7;275900.0
4;2.5;2490;2.0;0;0;2490;8;700000.0
3;2.0;1340;1.5;0;0;1340;7;545000.0
3;1.0;1270;1.0;0;150;1120;7;435010.0
3;1.75;1830;2.0;0;340;1490;7;283000.0
4;1.0;1730;1.5;0;0;1730;6;267950.0
2;1.0;1650;1.0;0;700;950;7;580000.0
3;1.5;1340;1.0;0;0;1340;7;245000.0
4;2.25;1930;1.0;0;630;1300;8;367500.0
2;1.0;1550;1.0;0;500;1050;7;555000.0
2;1.0;700;1.0;0;0;700;6;248000.0
3;1.0;1210;1.5;0;120;1090;7;450000.0
2;1.75;1440;1.0;0;0;1440;8;210000.0
2;1.75;1980;1.0;0;990;990;7;585000.0
4;1.75;1890;2.0;0;400;1490;7;860000.0
2;1.0;730;1.0;0;0;730;4;217000.0
3;2.25;2130;1.0;0;860;1270;8;283000.0
4;2.75;2770;2.0;0;0;2770;8;572000.0
3;2.5;1280;2.0;0;0;1280;7;415000.0
5;2.0;2130;1.5;0;860;1270;7;615000.0
3;1.5;1000;1.0;0;0;1000;7;378000.0
3;1.5;1380;1.0;0;590;790;7;235500.0
3;1.75;1930;1.0;0;0;1930;8;570000.0
4;1.75;2620;1.5;0;0;2620;9;720000.0
3;2.25;2700;2.0;0;940;1760;8;552500.0
4;2.0;1770;1.5;0;0;1770;7;620000.0
3;1.75;1550;1.5;0;0;1550;7;280000.0
3;3.5;3190;2.0;0;0;3190;10;780000.0
3;1.75;1450;1.0;0;0;1450;8;365000.0
3;2.5;2050;2.0;0;0;2050;9;465000.0
3;1.75;1840;1.0;0;790;1050;7;457500.0
5;3.0;3850;2.0;0;940;2910;9;925000.0
3;1.0;1180;1.0;0;0;1180;7;397990.0
3;1.0;1770;1.5;0;630;1140;7;373000.0
2;1.0;1070;1.0;0;0;1070;6;325000.0
2;1.0;1330;1.0;0;0;1330;7;450500.0
2;2.25;2550;2.0;0;690;1860;7;660000.0
5;3.0;4290;1.0;0;1810;2480;9;1705000.0
4;2.5;2150;1.0;0;1060;1090;7;414999.0
4;2.5;1850;1.0;0;420;1430;8;830000.0
2;2.5;2220;2.0;0;0;2220;9;1425000.0
3;2.25;1930;1.0;0;460;1470;7;273000.0
3;1.0;1220;1.0;0;0;1220;6;385000.0
4;2.5;4073;2.0;0;0;4073;8;510000.0
4;2.0;2640;2.0;0;600;2040;7;750000.0
2;1.0;1320;1.0;0;440;880;7;369000.0
4;2.5;2448;2.0;0;0;2448;9;447055.0
4;2.5;2870;2.0;0;0;2870;9;710000.0
4;3.5;3410;2.0;0;0;3410;10;1405000.0
4;2.75;2230;1.0;0;900;1330;7;323000.0
4;3.0;3110;2.5;0;600;2510;10;1415000.0
3;1.0;2200;1.0;0;600;1600;9;573500.0
3;2.0;1550;1.0;0;0;1550;6;249950.0
3;2.25;2570;1.0;0;0;2570;9;625000.0
3;1.0;1120;1.0;0;0;1120;7;195700.0
4;2.5;2310;2.0;0;0;2310;7;364950.0
4;2.5;2630;2.0;0;0;2630;9;585000.0
3;1.0;2010;1.0;0;800;1210;7;350000.0
4;2.5;1710;1.0;0;270;1440;9;749000.0
2;2.5;1050;2.0;0;0;1050;7;325000.0
3;1.0;1120;1.0;0;0;1120;7;435000.0
3;1.5;1310;1.0;0;0;1310;8;524000.0
3;2.5;3370;2.0;0;170;3200;7;515000.0
3;1.0;1020;1.0;0;0;1020;7;380000.0
2;1.0;580;1.0;0;0;580;5;90000.0
3;1.5;1900;1.5;0;260;1640;7;550000.0
3;1.75;1550;1.0;0;0;1550;7;199950.0
4;1.0;1600;1.5;0;0;1600;7;725000.0
3;1.75;1890;1.0;0;660;1230;7;271900.0
4;2.25;2200;1.0;0;770;1430;8;655000.0
4;2.5;2350;2.0;0;0;2350;8;399950.0
3;3.25;3620;2.0;0;890;2730;10;996000.0
3;1.0;1140;1.0;0;0;1140;6;330000.0
4;2.0;1750;1.0;0;0;1750;5;247000.0
4;2.5;2190;1.0;0;950;1240;7;1100000.0
2;1.0;680;1.0;0;0;680;5;275000.0
3;2.0;2000;2.0;0;0;2000;7;561000.0
4;2.5;2718;2.0;0;0;2718;8;388500.0
4;3.0;2000;1.5;0;0;2000;7;775000.0
2;1.0;840;1.0;0;0;840;6;209000.0
4;2.5;1980;2.0;0;0;1980;7;463000.0
3;1.75;1680;1.0;0;840;840;6;425000.0
4;2.5;2740;2.0;0;0;2740;9;672800.0
2;1.0;940;1.0;0;0;940;7;212700.0
4;1.75;1910;1.0;0;700;1210;7;475000.0
3;1.75;1350;1.0;0;0;1350;7;241250.0
4;1.75;2560;1.0;0;680;1880;7;518000.0
6;3.0;2020;1.0;0;790;1230;7;599950.0
3;1.5;1260;1.0;0;0;1260;7;245000.0
4;2.0;2180;2.0;0;0;2180;7;470000.0
4;1.75;2520;1.0;0;1200;1320;7;425000.0
4;2.5;2038;2.0;0;0;2038;8;319950.0
4;2.5;1980;2.0;0;0;1980;8;332000.0
4;3.0;2170;2.0;0;0;2170;8;560000.0
6;4.25;6900;2.0;0;2080;4820;9;1135000.0
3;2.25;2430;1.0;0;0;2430;8;524000.0
5;2.25;3260;2.0;0;0;3260;8;353950.0
3;2.0;2080;1.0;0;1040;1040;7;660000.0
4;2.5;3190;2.0;0;0;3190;10;589450.0
3;1.5;1730;1.0;0;730;1000;8;510000.0
3;2.25;2250;2.0;0;740;1510;8;750000.0
3;2.5;1570;1.0;0;460;1110;7;284200.0
2;1.0;900;1.0;0;0;900;6;235000.0
4;2.5;2900;1.0;0;1450;1450;8;1580000.0
4;1.75;2520;1.0;1;1100;1420;8;750000.0
3;2.5;1580;2.0;0;0;1580;7;280000.0
3;3.0;2430;1.0;0;280;2150;8;272000.0
3;2.0;1360;2.0;0;0;1360;7;396900.0
3;2.5;1470;2.0;0;0;1470;7;381000.0
4;2.5;3470;2.0;0;0;3470;10;875000.0
3;2.25;2130;1.0;0;760;1370;8;482975.0
4;2.75;3820;2.0;0;970;2850;9;770000.0
2;2.75;1370;2.0;0;290;1080;8;359000.0
3;2.25;1450;2.0;0;0;1450;7;297000.0
4;2.5;2230;2.0;0;600;1630;8;1003000.0
3;2.25;1420;3.0;0;0;1420;8;510000.0
4;3.0;1820;1.0;0;820;1000;7;320000.0
3;1.75;1380;1.0;0;0;1380;7;345000.0
4;2.5;2370;2.0;0;0;2370;8;338000.0
4;2.25;2500;2.0;0;0;2500;9;808000.0
4;2.25;2300;1.0;0;920;1380;7;417000.0
3;2.5;2555;2.0;0;0;2555;8;255000.0
4;2.5;3270;1.0;0;1580;1690;8;560000.0
4;2.25;3680;2.0;0;0;3680;9;425000.0
3;2.5;1460;2.0;0;0;1460;8;450000.0
4;2.5;2310;2.0;0;0;2310;8;334000.0
4;1.75;1710;1.5;0;0;1710;6;320000.0
2;2.0;1250;1.0;0;0;1250;7;163000.0
2;1.5;1110;3.0;0;0;1110;8;320000.0
4;1.0;1660;1.5;0;480;1180;7;535000.0
4;1.75;2110;1.0;0;0;2110;8;568000.0
3;2.5;1690;1.5;0;0;1690;8;719000.0
4;2.5;1850;2.0;0;0;1850;7;290000.0
3;1.75;1520;1.5;0;0;1520;7;738000.0
2;1.0;670;1.0;0;0;670;6;272000.0
3;1.5;1200;1.0;0;0;1200;6;229000.0
3;1.5;1010;1.0;0;0;1010;6;194000.0
4;3.25;3850;2.0;0;670;3180;11;1200000.0
4;2.5;2280;2.0;0;760;1520;8;597000.0
4;2.5;3920;2.0;0;0;3920;10;965000.0
4;1.75;2520;1.0;0;840;1680;8;525300.0
3;1.75;2000;1.0;0;880;1120;8;549000.0
4;2.5;3691;2.0;0;0;3691;8;800000.0
4;2.75;3400;2.0;0;0;3400;9;828200.0
4;3.75;4133;2.0;0;0;4133;11;979500.0
3;1.75;1600;1.0;0;0;1600;7;625000.0
2;2.5;1170;2.0;0;0;1170;9;482500.0
4;2.5;2460;2.0;0;0;2460;8;313000.0
3;2.25;1530;2.0;0;414;1116;7;390500.0
3;2.5;3820;2.0;0;0;3820;9;775000.0
3;1.0;1130;1.0;0;0;1130;7;354000.0
2;1.0;720;1.0;0;0;720;6;248500.0
3;3.25;4610;2.0;0;0;4610;9;750000.0
3;2.5;2230;2.0;0;0;2230;8;722000.0
4;2.25;1800;1.0;0;0;1800;8;225000.0
4;3.5;3190;2.0;0;0;3190;9;790000.0
5;4.0;3720;2.0;0;0;3720;10;960000.0
3;2.0;1630;1.0;0;0;1630;7;260000.0
3;2.25;1720;1.0;0;580;1140;7;628000.0
3;1.75;1800;2.0;0;0;1800;8;270000.0
4;2.0;1940;1.0;0;970;970;7;446000.0
3;1.5;1210;1.0;0;0;1210;6;219950.0
4;1.75;1850;1.0;0;0;1850;7;181100.0
4;1.5;1360;1.5;0;0;1360;7;201000.0
2;1.0;890;1.0;0;0;890;7;510000.0
2;1.0;1000;1.0;0;0;1000;7;397000.0
3;2.5;2380;1.5;0;0;2380;9;446250.0
4;2.25;3040;1.0;0;1100;1940;9;760000.0
3;2.0;1330;1.0;0;0;1330;7;259500.0
2;1.0;1300;1.0;0;0;1300;7;170000.0
3;2.5;1790;2.0;0;0;1790;8;530000.0
3;2.0;1160;1.0;0;580;580;5;775000.0
3;2.75;3070;2.0;0;630;2440;10;1000750.0
4;2.5;2900;1.0;0;1240;1660;8;500000.0
3;2.5;1520;2.0;0;480;1040;8;499950.0
4;2.25;2180;1.0;0;1080;1100;7;315000.0
3;1.0;1130;1.0;0;0;1130;6;227000.0
3;1.0;1110;1.0;0;0;1110;7;130000.0
3;1.75;1440;1.0;0;0;1440;7;337000.0
1;1.0;720;1.0;1;0;720;6;570000.0
4;2.5;2570;2.0;0;0;2570;8;561000.0
3;1.0;1230;1.5;0;0;1230;6;240000.0
4;2.5;2410;1.0;0;860;1550;8;520000.0
2;1.0;1290;2.0;0;0;1290;7;265000.0
3;2.25;1480;1.0;0;290;1190;7;291000.0
3;1.0;960;1.0;0;0;960;5;199999.0
4;2.25;1870;2.0;0;0;1870;7;299000.0
4;2.5;1910;2.0;0;0;1910;8;498500.0
3;1.75;1990;1.0;0;670;1320;7;345000.0
4;2.5;2430;2.0;0;0;2430;8;585000.0
3;1.75;1140;1.0;0;0;1140;7;269900.0
3;2.75;2480;1.5;0;590;1890;9;690000.0
4;3.25;3530;2.0;0;0;3530;11;995000.0
3;3.0;2600;1.5;0;710;1890;9;525000.0
3;1.0;1450;1.0;0;260;1190;7;585000.0
4;2.5;2720;2.0;0;0;2720;10;665000.0
4;2.5;2710;2.0;0;0;2710;9;482000.0
2;1.0;1400;1.5;0;300;1100;6;250000.0
4;1.75;1960;1.0;0;0;1960;8;285500.0
5;1.75;2140;1.0;0;0;2140;8;250750.0
4;3.5;4610;2.0;0;0;4610;10;960000.0
3;1.75;1250;1.0;0;0;1250;7;450000.0
3;1.0;1390;1.5;0;0;1390;7;299000.0
3;3.5;2480;2.0;0;0;2480;10;910000.0
3;1.75;1870;1.0;0;900;970;7;680000.0
4;4.0;4420;2.0;0;1010;3410;10;909500.0
3;1.75;1590;1.5;0;0;1590;6;280000.0
4;3.5;3260;2.0;0;630;2630;9;1550000.0
4;2.5;2980;1.0;0;1290;1690;8;623000.0
4;2.5;2170;2.0;0;0;2170;8;377000.0
3;1.75;2110;1.0;0;0;2110;8;743000.0
5;3.25;3800;1.0;0;1310;2490;7;380000.0
4;2.0;2360;2.0;0;0;2360;8;640000.0
3;1.0;1040;1.0;0;0;1040;7;217450.0
3;3.25;1390;2.0;0;250;1140;8;469000.0
2;1.0;840;1.0;0;0;840;7;445000.0
2;1.75;2870;2.0;0;1100;1770;8;570000.0
2;2.0;1070;2.0;0;350;720;9;259950.0
3;2.5;1830;2.0;0;0;1830;8;410000.0
4;2.5;2790;2.0;0;310;2480;9;445000.0
3;2.25;1830;1.0;0;0;1830;8;470000.0
4;2.5;1830;2.0;0;0;1830;7;353000.0
3;1.0;920;1.0;0;0;920;7;206000.0
3;2.25;2100;2.0;0;0;2100;8;270000.0
4;2.25;2760;2.0;0;970;1790;7;600000.0
4;3.0;4260;2.0;0;0;4260;11;2000000.0
4;2.25;2170;2.0;0;0;2170;8;566000.0
4;3.0;2430;1.0;0;1100;1330;7;518000.0
4;2.25;3410;2.0;0;1000;2410;8;471000.0
4;4.5;3080;2.0;0;1140;1940;8;1400000.0
2;2.25;2130;1.0;0;300;1830;8;779000.0
3;1.0;1560;1.0;0;420;1140;8;525000.0
4;2.25;1780;1.0;0;720;1060;7;350000.0
4;2.5;2060;1.0;0;740;1320;8;550000.0
4;1.75;2180;1.5;0;910;1270;6;334900.0
2;1.0;940;1.0;0;0;940;6;375000.0
3;1.75;1970;1.0;0;600;1370;8;501000.0
3;2.0;1200;1.0;0;0;1200;7;222000.0
3;2.5;1590;2.0;0;0;1590;7;356000.0
4;2.75;2230;1.0;0;910;1320;8;435000.0
2;1.0;760;1.0;0;0;760;6;122000.0
4;2.0;1880;1.0;0;0;1880;8;453000.0
3;2.25;2550;1.0;0;0;2550;9;490000.0
3;3.0;3700;1.0;0;1530;2170;10;1100000.0
3;2.25;1530;2.0;0;290;1240;8;460000.0
3;1.5;1190;1.0;0;0;1190;7;299000.0
4;2.75;3160;1.0;0;1580;1580;8;655000.0
3;2.5;1680;2.0;0;300;1380;8;518000.0
4;2.5;2770;2.0;0;370;2400;8;685000.0
3;1.0;1010;1.0;0;0;1010;6;350000.0
4;2.75;2200;1.0;0;790;1410;7;353000.0
4;3.5;3040;2.0;0;800;2240;8;415000.0
2;1.0;1100;1.5;0;0;1100;6;300000.0
5;3.25;2800;1.5;0;890;1910;10;1307000.0
4;2.5;3180;2.0;0;0;3180;9;780000.0
4;3.75;4090;2.0;0;690;3400;11;2400000.0
3;2.5;3100;1.0;0;0;3100;10;930000.0
4;2.5;2250;2.0;0;0;2250;8;375000.0
4;2.25;2130;1.0;0;0;2130;7;305000.0
3;1.0;1210;1.0;0;0;1210;6;205000.0
4;3.5;2950;2.0;0;680;2270;10;825750.0
2;1.0;1220;1.0;0;0;1220;7;350000.0
4;2.5;2060;2.0;0;0;2060;7;343888.0
5;4.0;4850;2.0;0;0;4850;10;975000.0
4;2.5;2180;2.0;0;0;2180;8;480000.0
3;1.5;1900;1.0;0;0;1900;8;230000.0
3;2.5;1800;2.0;0;560;1240;7;670000.0
4;2.75;2750;1.5;0;770;1980;8;1450000.0
4;3.25;4140;1.0;0;840;3300;10;2400000.0
4;1.75;2000;1.0;0;870;1130;7;595000.0
4;2.5;1996;2.0;0;0;1996;7;285000.0
3;2.0;1350;1.0;0;0;1350;7;400000.0
4;2.5;3280;2.0;0;0;3280;10;809950.0
3;1.0;1340;1.0;0;300;1040;7;409500.0
3;3.5;1690;2.0;0;320;1370;8;622000.0
4;2.25;2860;1.0;0;1220;1640;8;740000.0
4;2.5;4500;1.0;0;0;4500;13;2340000.0
5;3.0;3620;1.0;0;1720;1900;8;858000.0
3;1.5;1760;1.0;0;0;1760;7;272000.0
3;2.0;2800;1.0;0;1400;1400;7;650000.0
2;1.0;920;1.0;0;0;920;7;514000.0
3;2.25;1470;2.0;0;0;1470;7;468000.0
2;1.5;1360;2.0;0;0;1360;7;150000.0
3;1.75;1330;1.0;0;0;1330;7;381000.0
3;2.25;2780;2.0;0;0;2780;8;666000.0
5;2.5;2670;1.5;0;1050;1620;7;585000.0
4;1.0;1330;1.5;0;0;1330;6;615000.0
3;2.25;1840;1.0;0;470;1370;8;285000.0
3;2.5;2930;2.0;0;0;2930;10;905000.0
3;1.75;1410;2.0;0;0;1410;7;263000.0
3;2.5;2080;2.0;0;0;2080;7;368000.0
3;2.5;1180;3.0;0;0;1180;8;455000.0
4;2.5;2500;2.0;0;0;2500;8;684000.0
3;1.5;1390;1.0;0;0;1390;7;162500.0
4;2.5;3450;2.0;0;0;3450;10;832500.0
3;3.5;2480;2.0;0;0;2480;8;640000.0
3;1.5;1260;2.0;0;0;1260;7;333000.0
4;3.0;2950;2.0;0;970;1980;9;650000.0
2;1.0;920;1.0;0;0;920;6;417000.0
3;1.0;1020;1.0;0;0;1020;7;485000.0
2;2.0;1860;1.0;0;600;1260;8;265000.0
4;2.5;1910;2.0;0;0;1910;7;297500.0
4;3.0;2820;1.5;0;960;1860;7;697000.0
2;1.0;880;1.0;0;0;880;7;454000.0
3;1.75;1830;1.0;0;900;930;7;312500.0
4;2.0;2130;1.0;0;880;1250;7;233000.0
4;2.25;2160;1.0;0;700;1460;7;499950.0
3;2.5;1770;3.0;0;0;1770;8;671500.0
3;2.5;2000;2.0;0;0;2000;7;417000.0
4;2.25;2070;2.0;0;0;2070;7;495000.0
3;1.0;1060;1.0;0;0;1060;7;215000.0
4;2.75;2790;2.0;0;0;2790;8;533380.0
3;1.75;1540;1.0;0;770;770;6;263500.0
2;1.75;1270;2.0;0;0;1270;8;340000.0
5;2.75;3600;2.0;0;0;3600;9;679950.0
3;1.75;2410;1.0;0;0;2410;8;620000.0
3;2.25;1190;3.0;0;0;1190;8;475000.0
1;1.0;620;1.0;0;0;620;5;175000.0
3;1.75;2770;1.0;0;1200;1570;8;750000.0
4;2.5;2990;2.0;0;0;2990;8;600000.0
2;1.75;1220;1.0;0;0;1220;6;245000.0
3;1.5;1380;1.0;0;0;1380;7;209950.0
4;2.5;2905;2.0;0;0;2905;9;365000.0
4;1.75;1880;1.0;0;700;1180;7;266500.0
3;2.0;1460;2.0;0;0;1460;7;362764.0
4;2.75;2420;1.0;0;1000;1420;8;712500.0
5;1.0;2150;1.5;0;0;2150;7;550000.0
4;1.5;1370;1.5;0;0;1370;7;219000.0
3;2.25;2750;2.0;0;880;1870;7;510000.0
3;1.0;1210;1.5;0;0;1210;7;285000.0
4;1.75;1450;1.0;0;0;1450;7;362500.0
4;2.75;1890;2.0;0;690;1200;9;671000.0
3;2.5;2250;2.0;0;0;2250;8;549000.0
2;1.0;860;1.0;0;0;860;7;390000.0
4;2.5;3190;2.0;0;0;3190;8;387500.0
4;2.25;1660;1.0;0;550;1110;7;277500.0
3;2.5;1658;2.0;0;0;1658;8;263900.0
4;2.5;2830;2.0;0;0;2830;8;569000.0
3;1.75;2610;2.0;0;480;2130;8;1000000.0
4;2.5;3610;2.0;0;0;3610;10;875909.0
4;3.25;3080;2.0;0;850;2230;10;830000.0
1;1.0;930;1.0;0;0;930;6;210000.0
4;3.0;1920;1.0;0;0;1920;7;330000.0
4;1.75;1430;2.0;0;0;1430;7;485000.0
4;1.75;2120;1.0;0;900;1220;8;525000.0
3;2.5;2660;1.0;0;0;2660;8;589000.0
4;3.5;2380;2.0;0;630;1750;7;413000.0
5;2.75;3150;2.0;0;0;3150;9;819900.0
4;2.5;2480;2.0;0;0;2480;8;424950.0
8;4.0;4020;1.0;0;2010;2010;8;900000.0
5;2.0;2060;2.0;0;0;2060;7;580000.0
2;1.0;990;1.0;0;0;990;7;365000.0
3;2.5;1530;2.0;0;0;1530;7;320000.0
2;1.0;740;1.0;0;0;740;5;295000.0
5;2.25;2410;2.0;0;0;2410;8;648000.0
1;0.75;770;1.0;0;0;770;6;315000.0
3;1.0;840;1.0;0;0;840;6;169950.0
3;2.0;1790;1.0;0;0;1790;7;440000.0
2;1.0;1400;1.0;0;0;1400;7;325000.0
4;1.0;2420;2.0;0;0;2420;7;550000.0
4;2.0;1580;1.0;0;0;1580;7;405100.0
3;1.0;1070;1.0;0;0;1070;7;337000.0
4;2.0;1590;1.0;0;0;1590;7;670500.0
3;2.5;1650;2.0;0;0;1650;7;280000.0
4;3.5;3220;2.0;0;0;3220;9;640000.0
4;1.0;1260;1.5;0;0;1260;7;295000.0
4;3.25;3990;2.0;0;0;3990;11;2720000.0
4;2.0;2530;1.0;0;310;2220;8;813500.0
3;1.0;1130;1.0;0;0;1130;6;350000.0
3;1.75;1850;1.0;0;830;1020;7;580000.0
3;2.25;2140;2.0;0;0;2140;7;280000.0
4;3.25;4700;2.0;0;1280;3420;10;900000.0
3;1.0;1100;1.0;0;0;1100;7;168500.0
2;1.0;1140;1.5;0;130;1010;8;235000.0
3;2.5;1730;2.0;0;0;1730;7;315000.0
3;2.5;1256;3.0;0;0;1256;7;316750.0
3;2.0;1560;1.5;0;0;1560;7;539950.0
4;2.5;3680;2.0;0;0;3680;9;1900000.0
3;1.75;1890;1.0;0;600;1290;7;465500.0
3;1.0;1450;1.0;0;440;1010;7;306000.0
3;1.75;2310;1.0;0;730;1580;8;520000.0
3;3.0;2940;2.0;0;710;2230;9;1070000.0
3;3.0;1560;2.0;0;0;1560;9;503045.0
3;2.0;1410;1.0;0;0;1410;7;245000.0
3;1.5;1500;1.0;0;0;1500;7;215000.0
4;2.75;3210;1.0;0;1400;1810;7;750000.0
3;1.75;1770;1.0;0;530;1240;7;280000.0
3;2.5;2029;2.0;0;0;2029;9;384435.0
4;2.25;2580;1.0;0;960;1620;9;305000.0
4;2.75;2420;2.0;0;0;2420;8;376000.0
2;2.0;1570;1.0;0;0;1570;8;592350.0
3;2.0;1350;1.0;0;0;1350;7;233000.0
3;2.0;1270;3.0;0;0;1270;8;401000.0
4;2.75;2600;1.0;0;980;1620;8;555000.0
4;2.5;3420;2.0;0;0;3420;10;840000.0
4;2.5;1960;2.0;0;0;1960;7;260000.0
5;2.5;2690;2.0;0;0;2690;7;279000.0
5;2.25;2600;1.5;0;0;2600;8;265000.0
4;2.75;2220;1.0;0;1050;1170;7;680000.0
3;3.25;3240;2.0;0;470;2770;8;724500.0
3;1.5;1230;1.0;0;0;1230;7;270000.0
4;1.75;2860;1.0;0;1150;1710;8;583500.0
2;1.0;810;1.0;0;0;810;7;253500.0
3;2.5;2260;2.0;0;0;2260;8;496500.0
4;1.0;1010;1.0;0;260;750;6;350000.0
3;2.25;2570;2.0;0;0;2570;8;348000.0
4;1.5;1180;1.0;0;0;1180;7;220000.0
4;2.5;2310;2.0;0;0;2310;9;651100.0
4;2.75;2440;1.0;0;1000;1440;8;518000.0
4;3.25;3090;2.0;0;0;3090;9;850000.0
3;2.0;2920;1.0;0;1460;1460;8;795000.0
4;3.0;2570;2.0;0;820;1750;8;1180000.0
4;2.75;3950;1.0;0;1900;2050;10;900000.0
3;1.5;2210;1.0;0;1180;1030;7;500000.0
2;1.75;1740;1.5;0;0;1740;8;350000.0
4;3.0;3080;2.0;0;0;3080;10;560000.0
4;4.25;4960;2.5;0;1280;3680;11;1425000.0
2;1.0;810;1.0;0;0;810;5;238950.0
3;2.5;1480;3.0;0;0;1480;8;520000.0
3;2.0;1390;1.0;0;0;1390;7;206600.0
5;4.0;4180;2.0;0;0;4180;10;1255780.0
3;1.0;1300;1.0;0;0;1300;7;326188.0
3;1.5;1740;1.0;0;0;1740;8;616000.0
3;2.0;1230;1.5;0;0;1230;6;195000.0
4;2.25;2940;2.0;0;0;2940;9;1388000.0
5;2.5;3210;1.0;0;1380;1830;8;725000.0
4;2.5;3040;2.0;0;0;3040;8;647000.0
4;2.5;2160;2.0;0;0;2160;9;360000.0
3;2.5;2050;2.0;0;0;2050;8;457000.0
3;1.75;1160;1.0;0;580;580;6;137900.0
3;2.0;1590;1.0;0;0;1590;7;255000.0
4;2.5;2260;2.0;0;0;2260;8;339950.0
4;3.75;3560;2.0;0;0;3560;9;1160000.0
3;1.75;1550;2.0;0;0;1550;7;242500.0
3;2.5;1690;2.5;0;0;1690;8;640000.0
5;3.25;4230;2.0;0;370;3860;10;847700.0
3;2.0;2090;1.5;0;560;1530;8;1050000.0
2;2.0;1650;1.0;0;0;1650;6;265000.0
7;4.5;4140;1.0;0;2070;2070;7;565000.0
3;1.75;2600;1.0;0;1300;1300;8;700000.0
3;1.5;2030;1.0;0;950;1080;7;389000.0
3;2.5;2270;2.0;0;0;2270;8;585000.0
4;2.5;3750;2.0;0;0;3750;10;725000.0
4;3.0;3600;2.0;0;0;3600;9;1698000.0
3;2.25;2800;1.0;0;1380;1420;8;653000.0
3;2.5;1690;2.0;0;0;1690;7;305000.0
3;1.75;1460;1.0;0;450;1010;7;316500.0
3;2.5;2080;2.0;0;0;2080;8;506950.0
3;2.0;1290;3.0;0;0;1290;8;450000.0
3;2.0;1790;1.0;0;400;1390;7;307000.0
4;3.0;3520;2.0;0;0;3520;10;1395000.0
4;2.0;1450;1.5;0;0;1450;7;440000.0
4;2.5;1780;2.0;0;0;1780;7;455000.0
5;3.25;4300;2.0;0;1390;2910;10;1400000.0
3;2.0;2350;1.0;0;0;2350;7;539000.0
5;3.0;2730;1.0;0;1260;1470;8;440000.0
4;2.25;2450;1.0;0;800;1650;8;455000.0
4;1.0;1920;1.0;0;700;1220;7;170000.0
3;2.0;2900;1.0;0;1380;1520;8;616000.0
3;2.75;2130;2.0;0;1050;1080;9;525000.0
4;3.5;3350;1.0;0;1210;2140;7;400000.0
4;2.5;1790;1.0;0;500;1290;7;312000.0
4;2.5;2390;2.0;0;0;2390;7;425000.0
3;2.0;1830;1.0;0;0;1830;8;305000.0
3;1.75;2180;1.0;0;880;1300;8;860000.0
3;2.5;2090;2.0;0;0;2090;7;300000.0
3;2.5;2750;2.0;0;0;2750;9;556000.0
2;1.5;680;2.0;0;0;680;7;239000.0
2;1.0;710;1.0;0;0;710;6;320000.0
3;1.0;930;1.0;0;110;820;6;200000.0
3;2.75;2270;1.5;0;970;1300;6;199950.0
6;2.25;2930;2.0;0;800;2130;9;1225000.0
3;1.75;1350;1.0;0;0;1350;7;225000.0
3;2.25;1470;2.0;0;380;1090;8;432000.0
4;2.5;2160;1.0;0;500;1660;8;585000.0
3;2.5;2375;2.0;0;0;2375;9;712000.0
3;2.0;1980;1.5;0;910;1070;6;606000.0
3;1.0;1400;1.0;0;0;1400;7;194000.0
2;2.0;1210;2.0;0;430;780;8;610000.0
4;2.5;2690;2.0;0;0;2690;8;333000.0
3;2.25;1260;3.0;0;0;1260;7;275000.0
4;2.75;1560;1.0;0;500;1060;7;259900.0
3;2.5;1980;1.0;0;0;1980;7;760000.0
2;1.75;2040;1.0;0;610;1430;6;210500.0
4;2.75;3350;2.0;0;0;3350;10;739999.0
2;1.0;890;1.0;0;0;890;7;587750.0
3;1.5;2240;2.0;0;800;1440;9;700000.0
3;2.0;1340;1.5;0;0;1340;7;650000.0
2;1.0;880;1.0;0;0;880;6;400000.0
2;1.5;1050;2.0;0;0;1050;7;163500.0
2;2.25;1550;2.0;0;0;1550;8;325000.0
4;3.5;3600;2.0;0;880;2720;9;1350000.0
3;2.0;1390;1.0;0;0;1390;7;258000.0
4;3.25;1946;2.0;0;0;1946;7;485000.0
3;2.5;2620;2.0;0;0;2620;9;695000.0
3;1.0;1160;1.0;0;0;1160;5;182000.0
3;2.5;1820;2.0;0;0;1820;8;456000.0
3;2.0;2080;1.0;0;830;1250;7;389000.0
2;1.75;1950;1.0;0;940;1010;7;725000.0
5;1.5;1710;1.5;0;0;1710;7;158550.0
4;2.0;1960;2.0;0;0;1960;7;415000.0
3;2.5;1680;2.0;0;0;1680;8;550000.0
5;2.25;3120;2.0;0;0;3120;8;341500.0
4;1.75;1790;1.0;0;450;1340;8;809000.0
4;2.25;3240;2.0;0;510;2730;9;1065000.0
4;3.0;2060;1.0;0;630;1430;8;323400.0
4;2.5;1820;2.0;0;0;1820;7;359950.0
4;3.25;4130;2.0;0;0;4130;11;1900000.0
3;1.75;1980;1.0;0;710;1270;7;432500.0
3;1.5;2230;2.0;0;0;2230;8;685000.0
4;2.25;2590;2.0;0;0;2590;9;925000.0
2;2.5;2330;2.0;0;0;2330;8;577500.0
3;1.0;1540;1.0;0;450;1090;7;429000.0
3;2.25;1260;2.0;0;0;1260;7;449500.0
3;2.0;2660;1.0;0;0;2660;9;495000.0
2;1.0;860;1.0;0;0;860;6;290300.0
1;0.75;760;1.0;0;0;760;5;95000.0
3;2.0;1770;1.0;0;810;960;7;449500.0
5;2.75;2670;2.0;0;0;2670;8;494995.0
4;3.0;2520;2.0;0;0;2520;7;500000.0
2;1.0;900;1.0;0;0;900;6;275000.0
3;1.0;1050;1.0;0;0;1050;7;540000.0
4;2.5;2090;1.0;0;870;1220;7;465000.0
3;1.5;1330;1.0;0;0;1330;7;405000.0
4;2.75;3010;1.0;0;1450;1560;8;482000.0
3;1.75;1250;1.0;0;0;1250;7;268000.0
3;2.5;1660;2.0;0;0;1660;7;165000.0
3;2.0;1940;1.0;0;0;1940;9;732000.0
4;2.5;2170;1.0;0;950;1220;7;685000.0
4;3.0;3150;2.0;0;0;3150;9;727000.0
3;2.25;1606;3.0;0;0;1606;8;417250.0
4;1.5;1800;1.5;0;0;1800;8;875000.0
5;3.5;2800;2.5;0;0;2800;9;345600.0
3;2.5;1601;3.0;0;65;1536;7;378000.0
3;1.0;1090;1.5;0;0;1090;7;140000.0
4;3.25;3450;2.0;0;1020;2430;10;1035000.0
3;2.0;1990;1.5;0;760;1230;7;569000.0
4;1.0;1720;1.5;0;0;1720;7;500000.0
4;1.5;1790;1.0;0;580;1210;8;302000.0
3;2.25;1870;2.0;0;120;1750;8;615000.0
3;1.0;1140;2.0;0;0;1140;7;345000.0
4;1.75;2230;1.0;0;0;2230;7;537000.0
3;1.0;1370;1.5;0;0;1370;6;350000.0
4;2.5;2000;2.0;0;0;2000;7;349950.0
3;2.5;1690;2.0;0;540;1150;8;413565.0
4;2.5;2050;2.0;0;0;2050;7;398000.0
4;2.0;2220;1.0;0;0;2220;7;532500.0
2;1.0;1080;1.0;0;0;1080;6;230000.0
3;2.5;2070;1.5;0;800;1270;9;850830.0
6;2.5;2000;1.5;0;210;1790;7;265000.0
2;1.5;1020;2.0;0;0;1020;7;212000.0
4;1.75;1230;1.0;0;140;1090;7;569000.0
4;3.5;1460;3.0;0;0;1460;8;580000.0
3;1.5;2060;1.5;0;0;2060;7;294000.0
3;2.0;1330;1.0;0;0;1330;7;482500.0
4;2.5;2840;2.0;0;0;2840;9;500000.0
3;2.5;1212;3.0;0;0;1212;7;340000.0
4;2.75;2190;2.0;0;0;2190;8;465000.0
3;1.0;1210;1.0;0;0;1210;7;299950.0
3;1.75;2320;1.0;0;700;1620;8;364808.0
3;3.0;1680;3.0;0;0;1680;8;610950.0
3;1.75;2140;1.0;0;680;1460;7;271675.0
3;3.0;2390;2.0;0;710;1680;8;260000.0
3;1.0;1040;1.0;0;0;1040;6;210000.0
4;2.25;2460;1.0;0;740;1720;8;439950.0
5;2.75;3010;2.0;0;0;3010;10;837700.0
5;3.75;5340;2.5;0;1600;3740;10;2095000.0
3;3.0;1820;1.5;0;200;1620;8;775000.0
5;3.5;3390;2.0;0;0;3390;7;439900.0
3;2.5;2190;1.0;0;430;1760;8;702000.0
2;1.0;1040;1.0;0;0;1040;7;358803.0
3;1.75;1520;1.0;0;300;1220;8;360000.0
5;1.75;1320;1.0;0;200;1120;7;380000.0
3;1.0;1390;1.0;0;0;1390;5;230000.0
4;2.75;2200;1.5;0;0;2200;7;522500.0
2;1.5;1800;1.0;0;560;1240;7;345000.0
4;3.0;2760;2.0;0;920;1840;9;1340000.0
3;2.5;1530;1.5;0;520;1010;7;545000.0
4;2.25;1580;1.0;0;420;1160;8;525000.0
2;2.5;2170;1.0;0;0;2170;8;755000.0
3;1.5;2700;2.0;0;580;2120;7;524950.0
3;1.5;1190;1.0;0;0;1190;7;160134.0
3;1.75;1230;1.0;0;0;1230;7;175000.0
5;4.0;3040;2.0;0;760;2280;8;605000.0
4;2.5;2550;2.0;0;0;2550;9;512000.0
3;1.5;1860;1.0;0;370;1490;7;415000.0
3;1.0;1220;1.0;0;160;1060;7;500000.0
5;3.5;4600;2.0;0;1420;3180;10;880000.0
3;1.75;1630;1.0;0;0;1630;8;464000.0
2;1.0;1140;1.0;0;0;1140;7;390000.0
3;2.25;1940;2.0;0;0;1940;9;529000.0
4;2.0;1960;1.0;0;910;1050;7;435000.0
2;0.75;650;1.0;0;0;650;5;230000.0
4;2.5;1820;2.0;0;0;1820;7;349950.0
4;3.25;4740;2.0;0;0;4740;10;970000.0
3;1.75;1680;1.0;0;0;1680;8;640000.0
2;1.75;1440;1.0;0;310;1130;6;282500.0
4;2.5;2810;2.0;0;0;2810;9;747500.0
4;2.5;2550;1.0;0;1260;1290;8;660000.0
2;1.0;1210;1.5;0;0;1210;6;305000.0
4;2.75;3770;2.0;0;700;3070;9;1695000.0
3;1.75;1150;1.5;0;0;1150;6;370000.0
3;2.25;1580;1.0;0;0;1580;7;335000.0
5;2.75;3710;2.0;0;0;3710;9;641000.0
4;2.5;2830;2.0;0;0;2830;9;885000.0
3;2.25;1620;2.0;0;0;1620;8;800000.0
4;1.75;1620;1.0;0;0;1620;7;249950.0
3;1.75;1480;2.5;0;0;1480;9;620000.0
3;1.5;1360;3.0;0;0;1360;8;359000.0
4;2.25;2070;1.0;0;680;1390;8;625000.0
4;2.75;3010;2.0;0;0;3010;9;810000.0
3;2.0;1250;1.0;0;0;1250;7;208000.0
3;2.75;2216;1.0;0;0;2216;9;667000.0
3;1.5;1370;1.5;0;0;1370;6;199950.0
3;1.0;1040;1.0;0;0;1040;6;212000.0
4;2.5;1850;2.0;0;0;1850;7;305500.0
5;2.5;3100;2.0;0;0;3100;8;540000.0
3;1.0;1560;1.5;0;0;1560;7;669000.0
4;2.5;2460;2.0;0;0;2460;8;611000.0
4;2.25;2120;2.0;0;0;2120;8;800000.0
3;1.75;1390;1.0;0;460;930;7;400000.0
5;2.0;2500;2.0;1;0;2500;8;1700000.0
4;2.5;2390;2.0;0;0;2390;10;645500.0
3;2.5;1800;2.0;0;0;1800;8;391000.0
2;1.0;1400;1.0;0;500;900;7;180000.0
3;2.5;1510;1.0;0;480;1030;7;250000.0
4;3.25;1790;2.0;0;690;1100;7;385000.0
2;1.0;750;1.0;0;0;750;5;296000.0
3;2.5;3310;2.0;0;0;3310;9;419000.0
2;2.0;1350;1.0;0;0;1350;8;428000.0
3;1.75;1050;1.0;0;0;1050;7;237500.0
3;1.75;1340;1.0;0;0;1340;7;332000.0
4;2.5;2440;2.0;0;0;2440;9;631625.0
4;3.5;4210;2.0;0;0;4210;9;884744.0
4;2.5;2860;2.0;0;0;2860;8;645000.0
3;2.25;1890;1.0;0;0;1890;8;473000.0
3;3.5;1360;2.0;0;120;1240;8;397000.0
3;2.25;2210;1.0;0;750;1460;8;590000.0
3;1.75;2150;1.0;0;0;2150;7;437400.0
3;1.5;1200;1.0;0;140;1060;7;480000.0
3;2.5;3110;1.0;0;1550;1560;8;435000.0
4;2.5;2570;1.5;0;990;1580;8;889000.0
3;2.75;1670;3.0;0;320;1350;9;589950.0
4;1.5;1800;1.0;0;470;1330;7;272750.0
2;2.5;2380;1.0;0;0;2380;8;818000.0
8;2.75;2790;1.0;0;1320;1470;7;340000.0
4;2.5;2400;2.0;0;0;2400;8;425000.0
4;4.0;5545;2.0;0;1940;3605;11;937500.0
5;2.75;3190;1.0;0;1500;1690;9;1030000.0
4;3.25;3140;2.0;0;840;2300;7;409000.0
4;2.0;2530;1.0;0;1180;1350;8;880000.0
2;1.0;1410;1.0;0;470;940;7;442000.0
5;2.0;3110;1.0;0;1550;1560;7;719000.0
3;2.25;1481;2.0;0;0;1481;7;250000.0
4;2.25;2250;2.0;0;0;2250;8;569000.0
2;1.0;780;1.0;0;0;780;6;254922.0
4;3.75;2810;2.0;0;740;2070;8;492000.0
8;2.5;2280;1.5;0;1070;1210;7;700000.0
3;1.0;1660;1.0;0;390;1270;7;210000.0
4;2.25;1770;1.0;0;0;1770;7;480000.0
5;1.0;1500;1.5;0;0;1500;6;235000.0
3;1.0;1190;1.0;0;0;1190;6;320000.0
4;2.0;2120;1.5;0;400;1720;7;597000.0
4;1.75;2260;1.0;0;0;2260;9;980000.0
5;2.5;2620;1.0;0;1220;1400;7;330000.0
3;1.75;1360;1.0;0;0;1360;7;329950.0
5;3.0;3340;1.0;0;1220;2120;9;1328000.0
5;2.25;2340;2.0;0;0;2340;8;572000.0
3;2.0;1320;1.0;0;0;1320;7;225000.0
2;1.75;1550;1.0;0;0;1550;7;805000.0
3;1.0;1340;1.5;0;0;1340;6;199950.0
5;3.5;2640;2.0;0;0;2640;7;459000.0
5;4.5;4850;2.0;0;0;4850;10;569950.0
4;2.5;2800;1.0;0;1100;1700;8;569500.0
3;1.0;1020;1.0;0;240;780;6;235000.0
4;2.5;2820;2.0;0;0;2820;9;690000.0
3;1.5;1360;1.0;0;0;1360;7;370000.0
5;3.0;2200;1.0;0;1040;1160;7;547000.0
2;1.0;1050;1.0;0;0;1050;7;515000.0
4;2.5;2400;2.0;0;0;2400;8;456500.0
2;2.0;1350;3.0;0;0;1350;8;455000.0
3;1.75;1690;1.0;0;0;1690;7;289000.0
5;2.75;2920;1.0;0;1260;1660;8;850000.0
3;1.0;1440;1.5;0;0;1440;7;567500.0
5;3.25;3500;2.0;0;740;2760;8;632500.0
4;3.25;4290;1.0;0;1600;2690;11;1400000.0
3;2.25;2090;1.0;0;0;2090;7;383000.0
4;2.25;1780;2.0;0;0;1780;7;435000.0
4;2.5;2210;2.0;0;0;2210;8;353000.0
3;1.0;1730;1.0;0;300;1430;7;210000.0
5;2.0;1380;1.5;0;0;1380;7;462000.0
4;1.75;2180;1.0;0;620;1560;7;390000.0
5;3.25;3230;2.0;0;880;2350;9;815000.0
4;2.5;2650;2.0;0;0;2650;9;352000.0
3;2.0;2150;1.0;0;1070;1080;8;575000.0
4;2.5;2590;2.0;0;0;2590;10;674750.0
3;2.5;3490;1.5;0;1248;2242;9;692000.0
2;1.0;1180;1.0;0;0;1180;7;450000.0
3;2.25;3130;2.0;0;0;3130;8;710000.0
3;1.75;1720;1.0;0;580;1140;7;525000.0
2;1.0;1360;1.0;0;160;1200;7;640000.0
2;1.0;1350;1.0;0;0;1350;6;355000.0
2;1.0;880;1.0;0;0;880;6;199400.0
3;1.5;2080;1.0;0;890;1190;7;399950.0
5;4.0;2710;3.0;0;330;2380;10;1200000.0
3;1.0;1090;1.0;0;0;1090;6;289950.0
3;1.0;1200;1.0;0;0;1200;6;225205.0
2;1.0;1080;1.0;0;360;720;6;315000.0
3;1.75;2220;1.0;0;0;2220;8;585000.0
3;2.5;1920;2.0;0;0;1920;7;266950.0
4;2.0;1640;1.0;0;710;930;7;377000.0
5;3.5;4750;2.0;0;1400;3350;10;770000.0
3;2.5;1560;2.0;0;0;1560;7;275000.0
5;1.75;1680;1.0;0;0;1680;7;175000.0
3;1.75;1444;1.5;0;0;1444;7;420000.0
5;3.25;3490;1.0;0;1600;1890;8;610000.0
2;1.0;1030;1.0;0;0;1030;6;397380.0
3;1.5;1660;1.0;0;740;920;7;425000.0
5;3.75;3290;2.0;0;1100;2190;10;1385000.0
3;2.25;3060;1.5;0;1250;1810;9;970000.0
3;2.25;1584;2.0;0;0;1584;7;261000.0
3;2.0;2150;1.5;0;770;1380;7;597500.0
2;1.0;990;1.0;0;0;990;4;120000.0
4;2.25;2380;1.0;0;620;1760;8;319000.0
3;3.5;3390;2.0;0;350;3040;10;750000.0
3;1.75;1760;1.0;0;610;1150;7;240000.0
3;3.25;2950;2.0;0;500;2450;9;930000.0
3;1.75;1740;1.0;0;590;1150;8;585000.0
3;2.5;2200;2.0;0;670;1530;9;740000.0
3;1.0;1320;1.0;0;0;1320;6;185000.0
3;1.0;1310;1.0;0;0;1310;7;240000.0
4;2.5;2310;2.0;0;0;2310;9;685000.0
3;1.75;890;1.5;0;140;750;7;455000.0
3;2.25;1830;2.0;0;0;1830;8;379500.0
5;3.75;4130;2.0;0;960;3170;9;900000.0
5;3.0;3330;2.0;0;720;2610;11;1190000.0
3;1.75;1140;1.0;0;0;1140;7;120750.0
4;2.25;2280;1.5;0;320;1960;8;820000.0
5;2.75;2000;2.0;0;0;2000;7;300000.0
3;1.0;960;1.0;0;0;960;7;322000.0
4;2.5;2770;2.0;0;0;2770;9;533300.0
4;3.5;3130;3.0;0;0;3130;10;1010000.0
4;1.75;1450;1.5;0;270;1180;7;235000.0
3;1.5;1290;3.0;0;0;1290;7;440000.0
3;2.0;1760;1.0;0;0;1760;7;290000.0
2;1.5;830;2.0;0;0;830;7;334500.0
4;2.5;3030;1.5;0;0;3030;10;1050000.0
4;2.5;2290;2.0;0;0;2290;8;660000.0
4;2.5;2910;2.0;0;0;2910;8;585000.0
3;2.5;1980;2.0;0;0;1980;8;319950.0
4;1.75;2660;2.0;0;580;2080;8;896000.0
3;1.5;1760;1.5;0;470;1290;8;688000.0
3;1.0;820;1.0;0;0;820;6;305000.0
2;2.0;1350;1.0;0;0;1350;8;335000.0
3;1.75;1810;1.0;0;780;1030;7;360000.0
4;2.0;2450;1.0;0;1000;1450;7;800000.0
4;2.5;1840;2.0;0;0;1840;8;390000.0
3;2.5;1790;2.0;0;0;1790;8;541000.0
2;1.5;1084;2.0;0;0;1084;7;265000.0
3;2.25;1489;2.0;0;0;1489;7;260000.0
4;2.5;3480;2.0;0;0;3480;11;878000.0
3;1.5;1310;2.0;0;0;1310;7;325000.0
3;1.75;1960;1.0;0;880;1080;7;655000.0
4;2.75;4070;2.0;0;0;4070;9;845000.0
4;2.5;2700;2.0;0;0;2700;8;383962.0
3;1.75;2050;1.0;0;980;1070;7;568000.0
3;1.0;1710;1.5;0;0;1710;7;620000.0
2;1.0;1190;1.0;0;0;1190;7;587100.0
5;1.75;1730;1.0;0;680;1050;7;205000.0
3;1.0;1270;1.0;0;0;1270;7;240000.0
2;2.0;1500;3.0;0;0;1500;8;670000.0
2;2.25;1600;2.0;0;0;1600;7;492500.0
3;1.75;1240;1.5;0;0;1240;7;505000.0
3;1.0;1140;1.0;0;0;1140;7;309000.0
2;1.0;860;1.0;0;0;860;7;330000.0
3;2.5;2200;1.0;0;800;1400;7;1100000.0
4;2.5;2500;2.0;0;0;2500;9;639000.0
4;3.75;4475;2.0;1;1816;2659;12;2574000.0
4;1.75;1790;1.0;0;380;1410;8;455000.0
1;1.0;960;1.0;0;200;760;7;332000.0
3;2.0;1980;1.5;0;390;1590;8;703300.0
3;1.0;1220;1.0;0;0;1220;7;940000.0
2;1.0;960;1.0;0;0;960;6;290000.0
4;3.0;3720;1.0;0;1790;1930;9;875000.0
2;1.0;660;1.0;0;0;660;6;175000.0
2;1.5;1110;2.0;0;160;950;7;252500.0
3;1.0;1010;1.0;0;0;1010;7;225000.0
4;2.5;2150;2.0;0;0;2150;7;435000.0
4;1.5;1810;1.0;0;460;1350;8;560000.0
4;2.5;1920;2.0;0;0;1920;7;308950.0
4;1.75;1940;1.0;0;940;1000;7;628000.0
2;1.5;1140;1.0;0;510;630;7;355000.0
3;1.0;1360;1.0;0;300;1060;7;466950.0
2;1.0;920;1.0;0;0;920;6;285000.0
3;2.25;1570;1.0;0;400;1170;8;476000.0
3;3.75;3890;1.0;0;1500;2390;8;430000.0
3;1.0;1180;1.0;0;0;1180;7;215000.0
4;1.75;2440;1.0;0;1100;1340;8;566000.0
2;2.75;1350;2.0;0;230;1120;8;405500.0
4;2.25;2500;2.0;0;0;2500;8;760000.0
4;2.5;1950;2.0;0;0;1950;7;322000.0
4;2.0;1560;1.0;0;0;1560;7;449000.0
5;3.0;3070;2.0;0;0;3070;9;825000.0
3;1.75;1730;1.0;0;510;1220;8;499990.0
3;2.75;2730;2.0;0;1200;1530;8;570000.0
3;1.0;1200;1.0;0;0;1200;7;165050.0
4;2.5;1950;1.0;0;830;1120;7;428000.0
3;2.0;1270;1.0;0;0;1270;7;435000.0
4;2.5;2280;1.0;0;990;1290;7;575000.0
3;2.75;2460;2.0;0;0;2460;9;790000.0
4;2.5;2520;2.0;0;0;2520;8;575000.0
4;2.5;2560;2.0;0;0;2560;9;675000.0
3;2.0;1260;1.0;0;0;1260;7;290000.0
3;2.5;2120;2.0;0;0;2120;9;680000.0
4;2.5;2000;2.0;0;0;2000;7;320000.0
4;2.5;4020;2.0;0;0;4020;10;818000.0
3;1.0;910;1.0;0;0;910;7;221000.0
4;3.5;3845;2.0;0;0;3845;10;1750000.0
3;1.75;1530;3.0;0;0;1530;8;500000.0
5;2.0;1870;1.0;0;750;1120;7;455000.0
3;2.0;1760;1.0;0;800;960;7;629000.0
4;2.5;2620;2.0;0;0;2620;9;683000.0
4;2.5;4260;1.5;0;160;4100;8;635000.0
5;2.75;2880;2.0;0;0;2880;9;525000.0
4;2.5;2030;1.0;0;700;1330;8;598000.0
2;1.0;1030;1.5;0;0;1030;6;315000.0
5;2.75;2790;1.5;0;650;2140;7;288000.0
2;1.75;3050;2.0;0;0;3050;10;890000.0
3;1.75;2140;1.0;0;1070;1070;7;603500.0
4;3.75;3980;2.0;0;0;3980;10;925900.0
4;3.5;3370;2.0;0;900;2470;8;900000.0
3;1.75;1490;1.0;0;790;700;6;263000.0
4;1.0;1610;1.0;0;0;1610;7;269000.0
3;2.5;2500;1.0;0;730;1770;8;390000.0
3;2.5;1650;3.0;0;0;1650;8;428000.0
4;3.5;4730;1.5;0;460;4270;10;2453500.0
4;3.0;2290;2.0;0;680;1610;9;991700.0
4;2.5;2780;1.0;0;1190;1590;8;505000.0
2;2.5;1380;3.0;0;0;1380;9;552000.0
6;2.75;3240;1.0;0;1080;2160;6;370000.0
3;2.0;1870;1.0;0;810;1060;7;521000.0
3;2.5;1770;2.0;0;0;1770;8;420000.0
5;2.75;3360;2.0;0;0;3360;9;738515.0
4;3.0;2750;1.0;0;1120;1630;8;710000.0
3;2.25;2610;2.0;0;630;1980;7;1049000.0
3;3.0;3230;2.0;0;1010;2220;10;1260000.0
4;4.25;5584;2.0;0;0;5584;11;1680000.0
3;2.25;1350;2.0;0;300;1050;8;397500.0
3;2.5;4040;2.0;0;1140;2900;9;565000.0
4;2.5;2550;2.0;0;0;2550;9;699000.0
